all,quarter,industry_section_code,industry_section,industry_division,number_of_persons_engaged_total,number_of_persons_engaged_male,number_of_persons_engaged_female,number_of_vacancies,number_of_establishments
All,2000 Q1,C,Manufacturing,Manufacture of food products,17507,10836,6671,190,657
All,2000 Q1,C,Manufacturing,Manufacture of beverages,3221,2725,496,28,28
All,2000 Q1,C,Manufacturing,Manufacture of tobacco products,426,328,98,0,3
All,2000 Q1,C,Manufacturing,Manufacture of textiles,16297,10114,6183,73,1448
All,2000 Q1,C,Manufacturing,Manufacture of wearing apparel,52249,14862,37387,969,2793
All,2000 Q1,C,Manufacturing,"Manufacture of leather and related products; Manufacture of wood and of products of wood and cork, articles of straw and plaiting materials (except furniture and toys)",1486,1074,412,1,428
All,2000 Q1,C,Manufacturing,Manufacture of paper and paper products,3432,2550,882,15,619
All,2000 Q1,C,Manufacturing,Printing and reproduction of recorded media,28486,20622,7864,234,4050
All,2000 Q1,C,Manufacturing,Manufacture of coke and refined petroleum products; Manufacture of chemicals and chemical products,2364,1699,665,24,240
All,2000 Q1,C,Manufacturing,"Manufacture of pharmaceuticals, medicinal chemical and botanical products",2368,1060,1308,15,189
All,2000 Q1,C,Manufacturing,"Manufacture of rubber and plastics products (except furniture, toys, sports goods and stationery)",6335,4356,1979,49,1081
All,2000 Q1,C,Manufacturing,Manufacture of other non-metallic mineral products,2712,2276,436,2,258
All,2000 Q1,C,Manufacturing,Manufacture of basic metals,1387,1154,233,14,138
All,2000 Q1,C,Manufacturing,Manufacture of fabricated metal products (except machinery and equipment),10310,7682,2628,54,2065
All,2000 Q1,C,Manufacturing,"Manufacture of computer, electronic and optical products",24878,11244,13634,400,808
All,2000 Q1,C,Manufacturing,Manufacture of electrical equipment,5327,2987,2340,38,428
All,2000 Q1,C,Manufacturing,Manufacture of machinery and equipment n.e.c.,6355,5033,1322,47,1400
All,2000 Q1,C,Manufacturing,Body assembly of motor vehicles; Manufacture of other transport equipment,1545,1234,311,65,87
All,2000 Q1,C,Manufacturing,Manufacture of furniture,990,800,190,8,304
All,2000 Q1,C,Manufacturing,Other manufacturing,13819,9061,4758,149,2307
All,2000 Q1,C,Manufacturing,Repair and installation of machinery and equipment,14066,11268,2798,171,1819
All,2000 Q1,B,Mining and quarrying,Quarrying and other mining of non-metal ores,332,316,16,0,5
All,2000 Q1,D,Electricity and gas supply,Electricity and gas supply,8506,7448,1058,13,19
All,2000 Q1,E,"Sewerage, waste management and remediation services",Sewerage,640,376,264,0,37
All,2000 Q1,E,"Sewerage, waste management and remediation services","Waste collection, treatment and disposal; materials recovery",2552,1436,1116,22,227
All,2000 Q1,E,"Sewerage, waste management and remediation services",Remediation and other waste management services,128,90,38,0,15
All,2000 Q1,F,Construction,Construction sites (manual workers only),74521,69852,4669,240,1000
All,2000 Q1,F,Construction,Public sector sites,43286,40998,2288,230,454
All,2000 Q1,F,Construction,Public sector building sites,29316,27374,1942,58,231
All,2000 Q1,F,Construction,Public sector civil engineering sites,13970,13624,346,172,223
All,2000 Q1,F,Construction,Private sector sites,31235,28854,2381,10,546
All,2000 Q1,F,Construction,Private sector building sites,29641,27308,2333,10,476
All,2000 Q1,F,Construction,Private sector civil engineering sites,1594,1546,48,0,70
All,2000 Q1,G,"Import/export, wholesale and retail trades",Import and export trade,525741,288698,237043,9226,107571
All,2000 Q1,G,"Import/export, wholesale and retail trades",Wholesale,75203,48078,27125,1123,16315
All,2000 Q1,G,"Import/export, wholesale and retail trades",Retail trade,206025,98130,107895,2501,56535
All,2000 Q1,H,"Transportation, storage, postal and courier services",Land transport,44085,37709,6376,169,2677
All,2000 Q1,H,"Transportation, storage, postal and courier services",Water transport,10053,6399,3654,141,410
All,2000 Q1,H,"Transportation, storage, postal and courier services",Air transport,14061,5109,8952,75,116
All,2000 Q1,H,"Transportation, storage, postal and courier services",Warehousing and support services for transportation,53512,35251,18261,503,3922
All,2000 Q1,H,"Transportation, storage, postal and courier services",Postal and courier services,9622,6036,3586,304,581
All,2000 Q1,I,Accommodation and food services,Accommodation services,28399,16349,12050,547,772
All,2000 Q1,I,Accommodation and food services,Food and beverage services,190854,95894,94960,1504,10772
All,2000 Q1,J,Information and communications,Publishing,18675,11128,7547,338,1031
All,2000 Q1,J,Information and communications,"Motion picture, video and television programme production, sound recording and music publishing; Programming and broadcasting",14374,9267,5107,304,1531
All,2000 Q1,J,Information and communications,Telecommunications,25055,15677,9378,466,473
All,2000 Q1,J,Information and communications,Information technology services,15903,11177,4726,815,2675
All,2000 Q1,J,Information and communications,Information services,2602,1456,1146,59,306
All,2000 Q1,K,Financing and insurance,Financial services (except insurance and pension funding),109537,51567,57970,1438,6054
All,2000 Q1,K,Financing and insurance,Insurance,10445,4089,6356,401,166
All,2000 Q1,K,Financing and insurance,Services auxiliary to financial and insurance services,41392,21165,20227,1275,8704
All,2000 Q1,L,Real estate,Real estate,83676,57670,26006,1989,11290
All,2000 Q1,M,"Professional, scientific and technical services",Legal and accounting services,31619,14457,17162,481,4494
All,2000 Q1,M,"Professional, scientific and technical services",Activities of head offices; management and management consultancy services,17795,8682,9113,381,2955
All,2000 Q1,M,"Professional, scientific and technical services","Architecture and engineering services, technical testing and analysis",25857,17993,7864,409,2351
All,2000 Q1,M,"Professional, scientific and technical services",Scientific research and development,201,120,81,0,31
All,2000 Q1,M,"Professional, scientific and technical services",Advertising and market research,13472,7517,5955,488,2853
All,2000 Q1,M,"Professional, scientific and technical services","Veterinary services; Other professional, scientific and technical services",15364,8891,6473,358,4572
All,2000 Q1,N,Administrative and support services,Rental and leasing services,1969,1294,675,26,424
All,2000 Q1,N,Administrative and support services,Employment services,4725,1644,3081,212,1025
All,2000 Q1,N,Administrative and support services,"Travel agency, reservation service and related services",18131,8001,10130,178,2216
All,2000 Q1,N,Administrative and support services,Security and investigation services,31750,26574,5176,874,201
All,2000 Q1,N,Administrative and support services,Services to buildings and landscape care,40547,15679,24868,314,1057
All,2000 Q1,N,Administrative and support services,"Office administrative, office support and other business support services",15866,8798,7068,402,3488
All,2000 Q1,P,Education,Education,113095,43363,69732,531,3191
All,2000 Q1,Q,Human health and social work services,Human health services,66674,17511,49163,2271,4220
All,2000 Q1,Q,Human health and social work services,Residential care services,14248,2244,12004,490,846
All,2000 Q1,Q,Human health and social work services,Social work services,15739,2984,12755,115,1000
All,2000 Q1,R,"Arts, entertainment and recreation",Creative and performing arts activities,2057,1190,867,58,474
All,2000 Q1,R,"Arts, entertainment and recreation","Libraries, archives, museums and other cultural activities",322,112,210,5,63
All,2000 Q1,R,"Arts, entertainment and recreation",Amusement parks and theme parks,0,0,0,0,0
All,2000 Q1,R,"Arts, entertainment and recreation",Sports and other entertainment services,0,0,0,0,0
All,2000 Q1,S,Other services,Activities of membership organisations,9212,4185,5027,112,977
All,2000 Q1,S,Other services,"Repair of motor vehicles, motorcycles, computers, personal and household goods",18170,15213,2957,180,5381
All,2000 Q1,S,Other services,Other personal services,30016,14460,15556,783,6887
All,2000 Q2,C,Manufacturing,Manufacture of food products,17785,11115,6670,161,687
All,2000 Q2,C,Manufacturing,Manufacture of beverages,2749,2296,453,9,26
All,2000 Q2,C,Manufacturing,Manufacture of tobacco products,413,315,98,0,3
All,2000 Q2,C,Manufacturing,Manufacture of textiles,16011,9717,6294,131,1412
All,2000 Q2,C,Manufacturing,Manufacture of wearing apparel,54453,15428,39025,838,2985
All,2000 Q2,C,Manufacturing,"Manufacture of leather and related products; Manufacture of wood and of products of wood and cork, articles of straw and plaiting materials (except furniture and toys)",1870,1154,716,38,411
All,2000 Q2,C,Manufacturing,Manufacture of paper and paper products,3698,2678,1020,17,622
All,2000 Q2,C,Manufacturing,Printing and reproduction of recorded media,27160,19846,7314,251,4025
All,2000 Q2,C,Manufacturing,Manufacture of coke and refined petroleum products; Manufacture of chemicals and chemical products,2653,1875,778,47,277
All,2000 Q2,C,Manufacturing,"Manufacture of pharmaceuticals, medicinal chemical and botanical products",2682,1222,1460,10,190
All,2000 Q2,C,Manufacturing,"Manufacture of rubber and plastics products (except furniture, toys, sports goods and stationery)",6446,4566,1880,49,1122
All,2000 Q2,C,Manufacturing,Manufacture of other non-metallic mineral products,2886,2264,622,38,280
All,2000 Q2,C,Manufacturing,Manufacture of basic metals,1365,1156,209,9,130
All,2000 Q2,C,Manufacturing,Manufacture of fabricated metal products (except machinery and equipment),10733,7946,2787,67,2033
All,2000 Q2,C,Manufacturing,"Manufacture of computer, electronic and optical products",25339,11561,13778,386,804
All,2000 Q2,C,Manufacturing,Manufacture of electrical equipment,4738,2703,2035,50,423
All,2000 Q2,C,Manufacturing,Manufacture of machinery and equipment n.e.c.,6695,5191,1504,62,1492
All,2000 Q2,C,Manufacturing,Body assembly of motor vehicles; Manufacture of other transport equipment,1507,1223,284,42,89
All,2000 Q2,C,Manufacturing,Manufacture of furniture,992,803,189,3,283
All,2000 Q2,C,Manufacturing,Other manufacturing,14714,9828,4886,71,2365
All,2000 Q2,C,Manufacturing,Repair and installation of machinery and equipment,14805,12055,2750,208,1869
All,2000 Q2,B,Mining and quarrying,Quarrying and other mining of non-metal ores,233,220,13,0,5
All,2000 Q2,D,Electricity and gas supply,Electricity and gas supply,8290,6742,1548,22,18
All,2000 Q2,E,"Sewerage, waste management and remediation services",Sewerage,236,128,108,0,39
All,2000 Q2,E,"Sewerage, waste management and remediation services","Waste collection, treatment and disposal; materials recovery",2097,1269,828,32,232
All,2000 Q2,E,"Sewerage, waste management and remediation services",Remediation and other waste management services,84,47,37,0,14
All,2000 Q2,F,Construction,Construction sites (manual workers only),79261,74082,5179,450,1008
All,2000 Q2,F,Construction,Public sector sites,43782,41446,2336,274,443
All,2000 Q2,F,Construction,Public sector building sites,28621,26734,1887,178,225
All,2000 Q2,F,Construction,Public sector civil engineering sites,15161,14712,449,96,218
All,2000 Q2,F,Construction,Private sector sites,35479,32636,2843,176,565
All,2000 Q2,F,Construction,Private sector building sites,34104,31310,2794,176,494
All,2000 Q2,F,Construction,Private sector civil engineering sites,1375,1326,49,0,71
All,2000 Q2,G,"Import/export, wholesale and retail trades",Import and export trade,525894,286154,239740,8219,101751
All,2000 Q2,G,"Import/export, wholesale and retail trades",Wholesale,76269,48548,27721,955,16606
All,2000 Q2,G,"Import/export, wholesale and retail trades",Retail trade,209030,98424,110606,2584,55351
All,2000 Q2,H,"Transportation, storage, postal and courier services",Land transport,43786,37946,5840,325,2583
All,2000 Q2,H,"Transportation, storage, postal and courier services",Water transport,9433,6091,3342,101,390
All,2000 Q2,H,"Transportation, storage, postal and courier services",Air transport,14397,5317,9080,83,107
All,2000 Q2,H,"Transportation, storage, postal and courier services",Warehousing and support services for transportation,54206,35668,18538,615,4131
All,2000 Q2,H,"Transportation, storage, postal and courier services",Postal and courier services,12400,7981,4419,302,669
All,2000 Q2,I,Accommodation and food services,Accommodation services,28569,16433,12136,602,746
All,2000 Q2,I,Accommodation and food services,Food and beverage services,194870,98052,96818,1317,10656
All,2000 Q2,J,Information and communications,Publishing,18793,11294,7499,297,1031
All,2000 Q2,J,Information and communications,"Motion picture, video and television programme production, sound recording and music publishing; Programming and broadcasting",14486,9056,5430,246,1540
All,2000 Q2,J,Information and communications,Telecommunications,24557,15405,9152,493,428
All,2000 Q2,J,Information and communications,Information technology services,19437,13696,5741,1028,3207
All,2000 Q2,J,Information and communications,Information services,2741,1552,1189,43,385
All,2000 Q2,K,Financing and insurance,Financial services (except insurance and pension funding),107392,50206,57186,1829,6140
All,2000 Q2,K,Financing and insurance,Insurance,10312,3958,6354,435,166
All,2000 Q2,K,Financing and insurance,Services auxiliary to financial and insurance services,41393,20852,20541,1346,8780
All,2000 Q2,L,Real estate,Real estate,86767,59881,26886,2052,11832
All,2000 Q2,M,"Professional, scientific and technical services",Legal and accounting services,32719,14947,17772,511,4593
All,2000 Q2,M,"Professional, scientific and technical services",Activities of head offices; management and management consultancy services,17945,8824,9121,276,3208
All,2000 Q2,M,"Professional, scientific and technical services","Architecture and engineering services, technical testing and analysis",26514,18301,8213,430,2419
All,2000 Q2,M,"Professional, scientific and technical services",Scientific research and development,180,105,75,1,33
All,2000 Q2,M,"Professional, scientific and technical services",Advertising and market research,14913,7938,6975,318,2949
All,2000 Q2,M,"Professional, scientific and technical services","Veterinary services; Other professional, scientific and technical services",16703,10223,6480,489,4872
All,2000 Q2,N,Administrative and support services,Rental and leasing services,2139,1346,793,4,487
All,2000 Q2,N,Administrative and support services,Employment services,4755,1621,3134,73,1064
All,2000 Q2,N,Administrative and support services,"Travel agency, reservation service and related services",20515,8855,11660,258,2220
All,2000 Q2,N,Administrative and support services,Security and investigation services,32462,27719,4743,659,230
All,2000 Q2,N,Administrative and support services,Services to buildings and landscape care,41144,14449,26695,448,1106
All,2000 Q2,N,Administrative and support services,"Office administrative, office support and other business support services",20148,11022,9126,687,4345
All,2000 Q2,P,Education,Education,114322,43321,71001,698,3389
All,2000 Q2,Q,Human health and social work services,Human health services,67484,17772,49712,2164,4324
All,2000 Q2,Q,Human health and social work services,Residential care services,13827,1975,11852,570,789
All,2000 Q2,Q,Human health and social work services,Social work services,15805,2642,13163,71,1052
All,2000 Q2,R,"Arts, entertainment and recreation",Creative and performing arts activities,2285,1339,946,23,415
All,2000 Q2,R,"Arts, entertainment and recreation","Libraries, archives, museums and other cultural activities",309,106,203,6,54
All,2000 Q2,R,"Arts, entertainment and recreation",Amusement parks and theme parks,0,0,0,0,0
All,2000 Q2,R,"Arts, entertainment and recreation",Sports and other entertainment services,0,0,0,0,0
All,2000 Q2,S,Other services,Activities of membership organisations,9568,4517,5051,304,988
All,2000 Q2,S,Other services,"Repair of motor vehicles, motorcycles, computers, personal and household goods",18360,15382,2978,216,5317
All,2000 Q2,S,Other services,Other personal services,30373,14268,16105,645,6973
All,2000 Q3,C,Manufacturing,Manufacture of food products,18086,11185,6901,264,699
All,2000 Q3,C,Manufacturing,Manufacture of beverages,3003,2468,535,20,25
All,2000 Q3,C,Manufacturing,Manufacture of tobacco products,430,334,96,1,3
All,2000 Q3,C,Manufacturing,Manufacture of textiles,16199,9740,6459,77,1423
All,2000 Q3,C,Manufacturing,Manufacture of wearing apparel,50214,14175,36039,545,2669
All,2000 Q3,C,Manufacturing,"Manufacture of leather and related products; Manufacture of wood and of products of wood and cork, articles of straw and plaiting materials (except furniture and toys)",1412,925,487,4,347
All,2000 Q3,C,Manufacturing,Manufacture of paper and paper products,3696,2755,941,21,616
All,2000 Q3,C,Manufacturing,Printing and reproduction of recorded media,28038,20169,7869,273,4089
All,2000 Q3,C,Manufacturing,Manufacture of coke and refined petroleum products; Manufacture of chemicals and chemical products,2764,1913,851,23,264
All,2000 Q3,C,Manufacturing,"Manufacture of pharmaceuticals, medicinal chemical and botanical products",2384,1034,1350,13,192
All,2000 Q3,C,Manufacturing,"Manufacture of rubber and plastics products (except furniture, toys, sports goods and stationery)",5816,3959,1857,51,1014
All,2000 Q3,C,Manufacturing,Manufacture of other non-metallic mineral products,2456,2040,416,21,282
All,2000 Q3,C,Manufacturing,Manufacture of basic metals,1313,1115,198,9,100
All,2000 Q3,C,Manufacturing,Manufacture of fabricated metal products (except machinery and equipment),10445,7695,2750,25,1951
All,2000 Q3,C,Manufacturing,"Manufacture of computer, electronic and optical products",23815,10904,12911,310,680
All,2000 Q3,C,Manufacturing,Manufacture of electrical equipment,4599,2579,2020,18,361
All,2000 Q3,C,Manufacturing,Manufacture of machinery and equipment n.e.c.,6309,4927,1382,75,1347
All,2000 Q3,C,Manufacturing,Body assembly of motor vehicles; Manufacture of other transport equipment,1556,1337,219,41,101
All,2000 Q3,C,Manufacturing,Manufacture of furniture,850,724,126,4,266
All,2000 Q3,C,Manufacturing,Other manufacturing,13066,8609,4457,66,2283
All,2000 Q3,C,Manufacturing,Repair and installation of machinery and equipment,14285,11594,2691,111,1715
All,2000 Q3,B,Mining and quarrying,Quarrying and other mining of non-metal ores,212,198,14,0,5
All,2000 Q3,D,Electricity and gas supply,Electricity and gas supply,8461,6863,1598,6,19
All,2000 Q3,E,"Sewerage, waste management and remediation services",Sewerage,402,176,226,8,38
All,2000 Q3,E,"Sewerage, waste management and remediation services","Waste collection, treatment and disposal; materials recovery",1874,948,926,10,207
All,2000 Q3,E,"Sewerage, waste management and remediation services",Remediation and other waste management services,111,70,41,0,14
All,2000 Q3,F,Construction,Construction sites (manual workers only),80691,75829,4862,275,960
All,2000 Q3,F,Construction,Public sector sites,44253,41916,2337,239,422
All,2000 Q3,F,Construction,Public sector building sites,26691,24797,1894,189,209
All,2000 Q3,F,Construction,Public sector civil engineering sites,17562,17119,443,50,213
All,2000 Q3,F,Construction,Private sector sites,36438,33913,2525,36,538
All,2000 Q3,F,Construction,Private sector building sites,35060,32596,2464,26,471
All,2000 Q3,F,Construction,Private sector civil engineering sites,1378,1317,61,10,67
All,2000 Q3,G,"Import/export, wholesale and retail trades",Import and export trade,531827,290979,240848,7859,106760
All,2000 Q3,G,"Import/export, wholesale and retail trades",Wholesale,76661,48427,28234,1335,16118
All,2000 Q3,G,"Import/export, wholesale and retail trades",Retail trade,219709,103496,116213,2916,58481
All,2000 Q3,H,"Transportation, storage, postal and courier services",Land transport,44247,38403,5844,381,2556
All,2000 Q3,H,"Transportation, storage, postal and courier services",Water transport,10237,6565,3672,110,411
All,2000 Q3,H,"Transportation, storage, postal and courier services",Air transport,14621,5324,9297,67,107
All,2000 Q3,H,"Transportation, storage, postal and courier services",Warehousing and support services for transportation,54784,36554,18230,620,4208
All,2000 Q3,H,"Transportation, storage, postal and courier services",Postal and courier services,12189,7735,4454,255,626
All,2000 Q3,I,Accommodation and food services,Accommodation services,29304,16554,12750,558,785
All,2000 Q3,I,Accommodation and food services,Food and beverage services,194379,96069,98310,1902,11134
All,2000 Q3,J,Information and communications,Publishing,19339,11407,7932,323,1176
All,2000 Q3,J,Information and communications,"Motion picture, video and television programme production, sound recording and music publishing; Programming and broadcasting",14881,9680,5201,225,1486
All,2000 Q3,J,Information and communications,Telecommunications,26596,17133,9463,324,455
All,2000 Q3,J,Information and communications,Information technology services,21802,15767,6035,1040,3168
All,2000 Q3,J,Information and communications,Information services,3343,1997,1346,62,299
All,2000 Q3,K,Financing and insurance,Financial services (except insurance and pension funding),106525,49435,57090,1433,5875
All,2000 Q3,K,Financing and insurance,Insurance,10717,4049,6668,459,154
All,2000 Q3,K,Financing and insurance,Services auxiliary to financial and insurance services,45422,22814,22608,1834,9053
All,2000 Q3,L,Real estate,Real estate,85025,58092,26933,2214,11048
All,2000 Q3,M,"Professional, scientific and technical services",Legal and accounting services,33850,15324,18526,487,4827
All,2000 Q3,M,"Professional, scientific and technical services",Activities of head offices; management and management consultancy services,19856,9809,10047,319,2918
All,2000 Q3,M,"Professional, scientific and technical services","Architecture and engineering services, technical testing and analysis",27854,19396,8458,521,2315
All,2000 Q3,M,"Professional, scientific and technical services",Scientific research and development,165,89,76,5,39
All,2000 Q3,M,"Professional, scientific and technical services",Advertising and market research,14784,7905,6879,443,3037
All,2000 Q3,M,"Professional, scientific and technical services","Veterinary services; Other professional, scientific and technical services",15603,9337,6266,220,4547
All,2000 Q3,N,Administrative and support services,Rental and leasing services,2005,1287,718,41,442
All,2000 Q3,N,Administrative and support services,Employment services,4385,1578,2807,140,1089
All,2000 Q3,N,Administrative and support services,"Travel agency, reservation service and related services",19581,8629,10952,460,2243
All,2000 Q3,N,Administrative and support services,Security and investigation services,33361,28532,4829,717,185
All,2000 Q3,N,Administrative and support services,Services to buildings and landscape care,40432,14317,26115,711,1119
All,2000 Q3,N,Administrative and support services,"Office administrative, office support and other business support services",18230,10298,7932,342,3782
All,2000 Q3,P,Education,Education,115048,43471,71577,909,3575
All,2000 Q3,Q,Human health and social work services,Human health services,67603,17815,49788,2217,4387
All,2000 Q3,Q,Human health and social work services,Residential care services,17613,2864,14749,559,927
All,2000 Q3,Q,Human health and social work services,Social work services,18332,3445,14887,150,1264
All,2000 Q3,R,"Arts, entertainment and recreation",Creative and performing arts activities,1941,1179,762,28,427
All,2000 Q3,R,"Arts, entertainment and recreation","Libraries, archives, museums and other cultural activities",368,129,239,9,59
All,2000 Q3,R,"Arts, entertainment and recreation",Amusement parks and theme parks,0,0,0,0,0
All,2000 Q3,R,"Arts, entertainment and recreation",Sports and other entertainment services,0,0,0,0,0
All,2000 Q3,S,Other services,Activities of membership organisations,9150,4100,5050,111,969
All,2000 Q3,S,Other services,"Repair of motor vehicles, motorcycles, computers, personal and household goods",17948,14839,3109,310,5130
All,2000 Q3,S,Other services,Other personal services,27157,12865,14292,660,6892
All,2000 Q4,C,Manufacturing,Manufacture of food products,18980,11663,7317,124,709
All,2000 Q4,C,Manufacturing,Manufacture of beverages,3050,2250,800,9,25
All,2000 Q4,C,Manufacturing,Manufacture of tobacco products,434,334,100,1,3
All,2000 Q4,C,Manufacturing,Manufacture of textiles,15477,9395,6082,58,1369
All,2000 Q4,C,Manufacturing,Manufacture of wearing apparel,48342,13451,34891,465,2661
All,2000 Q4,C,Manufacturing,"Manufacture of leather and related products; Manufacture of wood and of products of wood and cork, articles of straw and plaiting materials (except furniture and toys)",1212,759,453,7,324
All,2000 Q4,C,Manufacturing,Manufacture of paper and paper products,3688,2798,890,17,617
All,2000 Q4,C,Manufacturing,Printing and reproduction of recorded media,28405,20545,7860,129,4075
All,2000 Q4,C,Manufacturing,Manufacture of coke and refined petroleum products; Manufacture of chemicals and chemical products,2227,1607,620,15,235
All,2000 Q4,C,Manufacturing,"Manufacture of pharmaceuticals, medicinal chemical and botanical products",2698,1126,1572,2,217
All,2000 Q4,C,Manufacturing,"Manufacture of rubber and plastics products (except furniture, toys, sports goods and stationery)",6390,4315,2075,45,983
All,2000 Q4,C,Manufacturing,Manufacture of other non-metallic mineral products,2341,1941,400,3,320
All,2000 Q4,C,Manufacturing,Manufacture of basic metals,1237,1065,172,15,90
All,2000 Q4,C,Manufacturing,Manufacture of fabricated metal products (except machinery and equipment),9815,7470,2345,28,1978
All,2000 Q4,C,Manufacturing,"Manufacture of computer, electronic and optical products",23180,10626,12554,225,624
All,2000 Q4,C,Manufacturing,Manufacture of electrical equipment,4593,2596,1997,14,345
All,2000 Q4,C,Manufacturing,Manufacture of machinery and equipment n.e.c.,6514,4908,1606,19,1507
All,2000 Q4,C,Manufacturing,Body assembly of motor vehicles; Manufacture of other transport equipment,1640,1397,243,22,91
All,2000 Q4,C,Manufacturing,Manufacture of furniture,765,631,134,0,247
All,2000 Q4,C,Manufacturing,Other manufacturing,12777,8109,4668,134,2212
All,2000 Q4,C,Manufacturing,Repair and installation of machinery and equipment,14051,11447,2604,253,1647
All,2000 Q4,B,Mining and quarrying,Quarrying and other mining of non-metal ores,154,142,12,0,6
All,2000 Q4,D,Electricity and gas supply,Electricity and gas supply,8203,7075,1128,21,19
All,2000 Q4,E,"Sewerage, waste management and remediation services",Sewerage,463,161,302,8,37
All,2000 Q4,E,"Sewerage, waste management and remediation services","Waste collection, treatment and disposal; materials recovery",2016,1029,987,1,208
All,2000 Q4,E,"Sewerage, waste management and remediation services",Remediation and other waste management services,93,27,66,0,13
All,2000 Q4,F,Construction,Construction sites (manual workers only),83924,78898,5026,177,978
All,2000 Q4,F,Construction,Public sector sites,44355,41944,2411,120,418
All,2000 Q4,F,Construction,Public sector building sites,24386,22560,1826,88,198
All,2000 Q4,F,Construction,Public sector civil engineering sites,19969,19384,585,32,220
All,2000 Q4,F,Construction,Private sector sites,39569,36954,2615,57,560
All,2000 Q4,F,Construction,Private sector building sites,37290,34759,2531,57,487
All,2000 Q4,F,Construction,Private sector civil engineering sites,2279,2195,84,0,73
All,2000 Q4,G,"Import/export, wholesale and retail trades",Import and export trade,508814,278037,230777,5098,101588
All,2000 Q4,G,"Import/export, wholesale and retail trades",Wholesale,67246,43681,23565,537,14862
All,2000 Q4,G,"Import/export, wholesale and retail trades",Retail trade,212666,97165,115501,2433,55522
All,2000 Q4,H,"Transportation, storage, postal and courier services",Land transport,43693,38036,5657,222,2690
All,2000 Q4,H,"Transportation, storage, postal and courier services",Water transport,9150,5834,3316,117,366
All,2000 Q4,H,"Transportation, storage, postal and courier services",Air transport,15629,6029,9600,104,109
All,2000 Q4,H,"Transportation, storage, postal and courier services",Warehousing and support services for transportation,51484,34511,16973,341,3908
All,2000 Q4,H,"Transportation, storage, postal and courier services",Postal and courier services,9684,6055,3629,119,566
All,2000 Q4,I,Accommodation and food services,Accommodation services,29283,16991,12292,529,774
All,2000 Q4,I,Accommodation and food services,Food and beverage services,189927,93503,96424,1146,10729
All,2000 Q4,J,Information and communications,Publishing,19116,11264,7852,216,1129
All,2000 Q4,J,Information and communications,"Motion picture, video and television programme production, sound recording and music publishing; Programming and broadcasting",14191,9134,5057,234,1460
All,2000 Q4,J,Information and communications,Telecommunications,26706,16899,9807,238,491
All,2000 Q4,J,Information and communications,Information technology services,23593,16855,6738,697,3475
All,2000 Q4,J,Information and communications,Information services,4518,2796,1722,90,382
All,2000 Q4,K,Financing and insurance,Financial services (except insurance and pension funding),106594,48686,57908,1095,5958
All,2000 Q4,K,Financing and insurance,Insurance,10969,4057,6912,361,169
All,2000 Q4,K,Financing and insurance,Services auxiliary to financial and insurance services,41145,20426,20719,584,9152
All,2000 Q4,L,Real estate,Real estate,81181,53751,27430,1289,10880
All,2000 Q4,M,"Professional, scientific and technical services",Legal and accounting services,34103,15939,18164,490,4561
All,2000 Q4,M,"Professional, scientific and technical services",Activities of head offices; management and management consultancy services,22112,11046,11066,200,3092
All,2000 Q4,M,"Professional, scientific and technical services","Architecture and engineering services, technical testing and analysis",26489,18073,8416,494,2405
All,2000 Q4,M,"Professional, scientific and technical services",Scientific research and development,165,92,73,8,42
All,2000 Q4,M,"Professional, scientific and technical services",Advertising and market research,14738,7928,6810,394,2864
All,2000 Q4,M,"Professional, scientific and technical services","Veterinary services; Other professional, scientific and technical services",15078,8837,6241,239,4710
All,2000 Q4,N,Administrative and support services,Rental and leasing services,2135,1450,685,31,543
All,2000 Q4,N,Administrative and support services,Employment services,6687,2350,4337,149,1222
All,2000 Q4,N,Administrative and support services,"Travel agency, reservation service and related services",19007,8494,10513,255,2187
All,2000 Q4,N,Administrative and support services,Security and investigation services,32333,28074,4259,786,126
All,2000 Q4,N,Administrative and support services,Services to buildings and landscape care,43450,14728,28722,412,1076
All,2000 Q4,N,Administrative and support services,"Office administrative, office support and other business support services",18765,10290,8475,151,4309
All,2000 Q4,P,Education,Education,117124,44288,72836,735,3676
All,2000 Q4,Q,Human health and social work services,Human health services,67110,17622,49488,2117,4405
All,2000 Q4,Q,Human health and social work services,Residential care services,16483,2748,13735,396,948
All,2000 Q4,Q,Human health and social work services,Social work services,17351,3488,13863,155,1260
All,2000 Q4,R,"Arts, entertainment and recreation",Creative and performing arts activities,2082,1152,930,22,491
All,2000 Q4,R,"Arts, entertainment and recreation","Libraries, archives, museums and other cultural activities",386,130,256,12,62
All,2000 Q4,R,"Arts, entertainment and recreation",Amusement parks and theme parks,0,0,0,0,0
All,2000 Q4,R,"Arts, entertainment and recreation",Sports and other entertainment services,0,0,0,0,0
All,2000 Q4,S,Other services,Activities of membership organisations,8740,3916,4824,124,928
All,2000 Q4,S,Other services,"Repair of motor vehicles, motorcycles, computers, personal and household goods",18802,15492,3310,176,5202
All,2000 Q4,S,Other services,Other personal services,29405,12761,16644,321,6999
All,2001 Q1,C,Manufacturing,Manufacture of food products,18549,11225,7324,153,723
All,2001 Q1,C,Manufacturing,Manufacture of beverages,3184,2563,621,17,29
All,2001 Q1,C,Manufacturing,Manufacture of tobacco products,433,340,93,3,3
All,2001 Q1,C,Manufacturing,Manufacture of textiles,14533,8953,5580,92,1289
All,2001 Q1,C,Manufacturing,Manufacture of wearing apparel,45363,12504,32859,544,2585
All,2001 Q1,C,Manufacturing,"Manufacture of leather and related products; Manufacture of wood and of products of wood and cork, articles of straw and plaiting materials (except furniture and toys)",1153,734,419,7,309
All,2001 Q1,C,Manufacturing,Manufacture of paper and paper products,3850,2911,939,19,609
All,2001 Q1,C,Manufacturing,Printing and reproduction of recorded media,27011,19584,7427,180,4013
All,2001 Q1,C,Manufacturing,Manufacture of coke and refined petroleum products; Manufacture of chemicals and chemical products,2348,1697,651,14,247
All,2001 Q1,C,Manufacturing,"Manufacture of pharmaceuticals, medicinal chemical and botanical products",2449,1046,1403,25,176
All,2001 Q1,C,Manufacturing,"Manufacture of rubber and plastics products (except furniture, toys, sports goods and stationery)",5556,3720,1836,48,936
All,2001 Q1,C,Manufacturing,Manufacture of other non-metallic mineral products,2298,1936,362,19,306
All,2001 Q1,C,Manufacturing,Manufacture of basic metals,1218,1028,190,6,80
All,2001 Q1,C,Manufacturing,Manufacture of fabricated metal products (except machinery and equipment),9360,7151,2209,51,1849
All,2001 Q1,C,Manufacturing,"Manufacture of computer, electronic and optical products",21658,9972,11686,168,611
All,2001 Q1,C,Manufacturing,Manufacture of electrical equipment,4403,2489,1914,16,335
All,2001 Q1,C,Manufacturing,Manufacture of machinery and equipment n.e.c.,5906,4487,1419,21,1293
All,2001 Q1,C,Manufacturing,Body assembly of motor vehicles; Manufacture of other transport equipment,1666,1434,232,30,108
All,2001 Q1,C,Manufacturing,Manufacture of furniture,1075,913,162,0,272
All,2001 Q1,C,Manufacturing,Other manufacturing,12397,7962,4435,159,2145
All,2001 Q1,C,Manufacturing,Repair and installation of machinery and equipment,14462,11954,2508,162,1667
All,2001 Q1,B,Mining and quarrying,Quarrying and other mining of non-metal ores,203,189,14,0,6
All,2001 Q1,D,Electricity and gas supply,Electricity and gas supply,8453,7304,1149,8,19
All,2001 Q1,E,"Sewerage, waste management and remediation services",Sewerage,446,219,227,2,36
All,2001 Q1,E,"Sewerage, waste management and remediation services","Waste collection, treatment and disposal; materials recovery",2117,1058,1059,10,199
All,2001 Q1,E,"Sewerage, waste management and remediation services",Remediation and other waste management services,128,79,49,0,13
All,2001 Q1,F,Construction,Construction sites (manual workers only),87813,81351,6462,248,1008
All,2001 Q1,F,Construction,Public sector sites,44558,42066,2492,149,431
All,2001 Q1,F,Construction,Public sector building sites,23204,21389,1815,52,199
All,2001 Q1,F,Construction,Public sector civil engineering sites,21354,20677,677,97,232
All,2001 Q1,F,Construction,Private sector sites,43255,39285,3970,99,577
All,2001 Q1,F,Construction,Private sector building sites,40214,36411,3803,99,505
All,2001 Q1,F,Construction,Private sector civil engineering sites,3041,2874,167,0,72
All,2001 Q1,G,"Import/export, wholesale and retail trades",Import and export trade,512346,281101,231245,6693,103447
All,2001 Q1,G,"Import/export, wholesale and retail trades",Wholesale,68226,44544,23682,653,15856
All,2001 Q1,G,"Import/export, wholesale and retail trades",Retail trade,213372,96971,116401,2428,57701
All,2001 Q1,H,"Transportation, storage, postal and courier services",Land transport,44566,38580,5986,364,2800
All,2001 Q1,H,"Transportation, storage, postal and courier services",Water transport,9498,6213,3285,90,381
All,2001 Q1,H,"Transportation, storage, postal and courier services",Air transport,16009,6096,9913,168,107
All,2001 Q1,H,"Transportation, storage, postal and courier services",Warehousing and support services for transportation,54435,35969,18466,492,3974
All,2001 Q1,H,"Transportation, storage, postal and courier services",Postal and courier services,10819,6970,3849,171,584
All,2001 Q1,I,Accommodation and food services,Accommodation services,28900,16627,12273,595,761
All,2001 Q1,I,Accommodation and food services,Food and beverage services,193266,95095,98171,1597,11046
All,2001 Q1,J,Information and communications,Publishing,18549,11128,7421,227,1089
All,2001 Q1,J,Information and communications,"Motion picture, video and television programme production, sound recording and music publishing; Programming and broadcasting",12736,7845,4891,160,1467
All,2001 Q1,J,Information and communications,Telecommunications,27378,17281,10097,421,488
All,2001 Q1,J,Information and communications,Information technology services,23877,17027,6850,750,3428
All,2001 Q1,J,Information and communications,Information services,3512,2130,1382,68,379
All,2001 Q1,K,Financing and insurance,Financial services (except insurance and pension funding),106204,48626,57578,1882,5809
All,2001 Q1,K,Financing and insurance,Insurance,10875,4072,6803,367,155
All,2001 Q1,K,Financing and insurance,Services auxiliary to financial and insurance services,42490,21500,20990,815,9206
All,2001 Q1,L,Real estate,Real estate,77577,52009,25568,1322,10029
All,2001 Q1,M,"Professional, scientific and technical services",Legal and accounting services,31303,14460,16843,473,4582
All,2001 Q1,M,"Professional, scientific and technical services",Activities of head offices; management and management consultancy services,20033,9535,10498,367,3233
All,2001 Q1,M,"Professional, scientific and technical services","Architecture and engineering services, technical testing and analysis",26040,17953,8087,363,2411
All,2001 Q1,M,"Professional, scientific and technical services",Scientific research and development,198,119,79,4,44
All,2001 Q1,M,"Professional, scientific and technical services",Advertising and market research,14466,7690,6776,273,2862
All,2001 Q1,M,"Professional, scientific and technical services","Veterinary services; Other professional, scientific and technical services",15754,9269,6485,241,4757
All,2001 Q1,N,Administrative and support services,Rental and leasing services,1969,1319,650,34,514
All,2001 Q1,N,Administrative and support services,Employment services,7127,2664,4463,153,1179
All,2001 Q1,N,Administrative and support services,"Travel agency, reservation service and related services",18162,8192,9970,255,2159
All,2001 Q1,N,Administrative and support services,Security and investigation services,34655,29432,5223,731,130
All,2001 Q1,N,Administrative and support services,Services to buildings and landscape care,41387,13627,27760,304,1106
All,2001 Q1,N,Administrative and support services,"Office administrative, office support and other business support services",19284,10651,8633,418,3874
All,2001 Q1,P,Education,Education,121499,45701,75798,768,3750
All,2001 Q1,Q,Human health and social work services,Human health services,69391,19769,49622,2060,4384
All,2001 Q1,Q,Human health and social work services,Residential care services,17106,2453,14653,569,922
All,2001 Q1,Q,Human health and social work services,Social work services,18619,3737,14882,191,1359
All,2001 Q1,R,"Arts, entertainment and recreation",Creative and performing arts activities,2267,1379,888,11,511
All,2001 Q1,R,"Arts, entertainment and recreation","Libraries, archives, museums and other cultural activities",388,143,245,8,58
All,2001 Q1,R,"Arts, entertainment and recreation",Amusement parks and theme parks,0,0,0,0,0
All,2001 Q1,R,"Arts, entertainment and recreation",Sports and other entertainment services,0,0,0,0,0
All,2001 Q1,S,Other services,Activities of membership organisations,9240,4194,5046,105,938
All,2001 Q1,S,Other services,"Repair of motor vehicles, motorcycles, computers, personal and household goods",17585,14808,2777,166,4955
All,2001 Q1,S,Other services,Other personal services,30104,13844,16260,770,7274
All,2001 Q2,C,Manufacturing,Manufacture of food products,19202,11680,7522,163,772
All,2001 Q2,C,Manufacturing,Manufacture of beverages,3160,2531,629,27,26
All,2001 Q2,C,Manufacturing,Manufacture of tobacco products,435,343,92,0,3
All,2001 Q2,C,Manufacturing,Manufacture of textiles,15301,9180,6121,83,1336
All,2001 Q2,C,Manufacturing,Manufacture of wearing apparel,46239,12904,33335,652,2584
All,2001 Q2,C,Manufacturing,"Manufacture of leather and related products; Manufacture of wood and of products of wood and cork, articles of straw and plaiting materials (except furniture and toys)",1163,809,354,6,332
All,2001 Q2,C,Manufacturing,Manufacture of paper and paper products,3720,2687,1033,21,622
All,2001 Q2,C,Manufacturing,Printing and reproduction of recorded media,28109,19914,8195,197,4018
All,2001 Q2,C,Manufacturing,Manufacture of coke and refined petroleum products; Manufacture of chemicals and chemical products,2414,1738,676,20,253
All,2001 Q2,C,Manufacturing,"Manufacture of pharmaceuticals, medicinal chemical and botanical products",2283,942,1341,11,186
All,2001 Q2,C,Manufacturing,"Manufacture of rubber and plastics products (except furniture, toys, sports goods and stationery)",5851,3747,2104,25,994
All,2001 Q2,C,Manufacturing,Manufacture of other non-metallic mineral products,2163,1842,321,8,266
All,2001 Q2,C,Manufacturing,Manufacture of basic metals,1231,1043,188,10,76
All,2001 Q2,C,Manufacturing,Manufacture of fabricated metal products (except machinery and equipment),9034,6928,2106,103,1819
All,2001 Q2,C,Manufacturing,"Manufacture of computer, electronic and optical products",19899,9448,10451,90,570
All,2001 Q2,C,Manufacturing,Manufacture of electrical equipment,4369,2494,1875,22,338
All,2001 Q2,C,Manufacturing,Manufacture of machinery and equipment n.e.c.,6423,5017,1406,33,1328
All,2001 Q2,C,Manufacturing,Body assembly of motor vehicles; Manufacture of other transport equipment,1611,1332,279,39,112
All,2001 Q2,C,Manufacturing,Manufacture of furniture,619,541,78,5,222
All,2001 Q2,C,Manufacturing,Other manufacturing,12568,8211,4357,75,2165
All,2001 Q2,C,Manufacturing,Repair and installation of machinery and equipment,14372,11420,2952,158,1700
All,2001 Q2,B,Mining and quarrying,Quarrying and other mining of non-metal ores,204,190,14,0,8
All,2001 Q2,D,Electricity and gas supply,Electricity and gas supply,8238,7167,1071,5,19
All,2001 Q2,E,"Sewerage, waste management and remediation services",Sewerage,471,242,229,0,38
All,2001 Q2,E,"Sewerage, waste management and remediation services","Waste collection, treatment and disposal; materials recovery",2081,1022,1059,21,192
All,2001 Q2,E,"Sewerage, waste management and remediation services",Remediation and other waste management services,62,43,19,0,13
All,2001 Q2,F,Construction,Construction sites (manual workers only),80269,74941,5328,111,975
All,2001 Q2,F,Construction,Public sector sites,36645,34621,2024,61,420
All,2001 Q2,F,Construction,Public sector building sites,17464,16131,1333,16,188
All,2001 Q2,F,Construction,Public sector civil engineering sites,19181,18490,691,45,232
All,2001 Q2,F,Construction,Private sector sites,43624,40320,3304,50,555
All,2001 Q2,F,Construction,Private sector building sites,41155,37948,3207,50,473
All,2001 Q2,F,Construction,Private sector civil engineering sites,2469,2372,97,0,82
All,2001 Q2,G,"Import/export, wholesale and retail trades",Import and export trade,503364,273324,230040,3841,100365
All,2001 Q2,G,"Import/export, wholesale and retail trades",Wholesale,77204,49230,27974,717,17818
All,2001 Q2,G,"Import/export, wholesale and retail trades",Retail trade,225301,102811,122490,2056,58706
All,2001 Q2,H,"Transportation, storage, postal and courier services",Land transport,44242,38447,5795,174,2892
All,2001 Q2,H,"Transportation, storage, postal and courier services",Water transport,9529,6301,3228,47,373
All,2001 Q2,H,"Transportation, storage, postal and courier services",Air transport,16220,6232,9988,114,110
All,2001 Q2,H,"Transportation, storage, postal and courier services",Warehousing and support services for transportation,56895,37041,19854,413,4109
All,2001 Q2,H,"Transportation, storage, postal and courier services",Postal and courier services,11251,7264,3987,127,617
All,2001 Q2,I,Accommodation and food services,Accommodation services,29009,16705,12304,341,772
All,2001 Q2,I,Accommodation and food services,Food and beverage services,198531,96248,102283,1023,11585
All,2001 Q2,J,Information and communications,Publishing,18867,10969,7898,176,1211
All,2001 Q2,J,Information and communications,"Motion picture, video and television programme production, sound recording and music publishing; Programming and broadcasting",15772,9915,5857,178,1586
All,2001 Q2,J,Information and communications,Telecommunications,27859,17556,10303,319,468
All,2001 Q2,J,Information and communications,Information technology services,25581,17708,7873,622,3622
All,2001 Q2,J,Information and communications,Information services,4313,2745,1568,18,333
All,2001 Q2,K,Financing and insurance,Financial services (except insurance and pension funding),106203,49637,56566,1884,6208
All,2001 Q2,K,Financing and insurance,Insurance,11949,4677,7272,317,152
All,2001 Q2,K,Financing and insurance,Services auxiliary to financial and insurance services,44209,22205,22004,923,9202
All,2001 Q2,L,Real estate,Real estate,83549,57373,26176,1534,11003
All,2001 Q2,M,"Professional, scientific and technical services",Legal and accounting services,32275,14677,17598,299,4698
All,2001 Q2,M,"Professional, scientific and technical services",Activities of head offices; management and management consultancy services,21256,10108,11148,297,3585
All,2001 Q2,M,"Professional, scientific and technical services","Architecture and engineering services, technical testing and analysis",28921,19866,9055,389,2439
All,2001 Q2,M,"Professional, scientific and technical services",Scientific research and development,174,101,73,1,46
All,2001 Q2,M,"Professional, scientific and technical services",Advertising and market research,14752,7685,7067,210,2952
All,2001 Q2,M,"Professional, scientific and technical services","Veterinary services; Other professional, scientific and technical services",16826,9879,6947,342,5067
All,2001 Q2,N,Administrative and support services,Rental and leasing services,1748,1104,644,0,462
All,2001 Q2,N,Administrative and support services,Employment services,7312,2667,4645,144,1364
All,2001 Q2,N,Administrative and support services,"Travel agency, reservation service and related services",18567,7805,10762,259,2195
All,2001 Q2,N,Administrative and support services,Security and investigation services,33436,28609,4827,629,117
All,2001 Q2,N,Administrative and support services,Services to buildings and landscape care,42766,15393,27373,198,1220
All,2001 Q2,N,Administrative and support services,"Office administrative, office support and other business support services",17155,9425,7730,269,3902
All,2001 Q2,P,Education,Education,121827,45423,76404,698,3978
All,2001 Q2,Q,Human health and social work services,Human health services,70399,20018,50381,1930,4525
All,2001 Q2,Q,Human health and social work services,Residential care services,18136,2553,15583,398,923
All,2001 Q2,Q,Human health and social work services,Social work services,23155,4952,18203,240,1744
All,2001 Q2,R,"Arts, entertainment and recreation",Creative and performing arts activities,2169,1312,857,12,485
All,2001 Q2,R,"Arts, entertainment and recreation","Libraries, archives, museums and other cultural activities",376,136,240,7,64
All,2001 Q2,R,"Arts, entertainment and recreation",Amusement parks and theme parks,0,0,0,0,0
All,2001 Q2,R,"Arts, entertainment and recreation",Sports and other entertainment services,0,0,0,0,0
All,2001 Q2,S,Other services,Activities of membership organisations,9547,4293,5254,139,952
All,2001 Q2,S,Other services,"Repair of motor vehicles, motorcycles, computers, personal and household goods",18305,15212,3093,208,5311
All,2001 Q2,S,Other services,Other personal services,30242,13641,16601,494,7560
All,2001 Q3,C,Manufacturing,Manufacture of food products,19501,11603,7898,215,729
All,2001 Q3,C,Manufacturing,Manufacture of beverages,3321,2711,610,12,27
All,2001 Q3,C,Manufacturing,Manufacture of tobacco products,442,348,94,0,3
All,2001 Q3,C,Manufacturing,Manufacture of textiles,15042,8927,6115,30,1281
All,2001 Q3,C,Manufacturing,Manufacture of wearing apparel,43776,12043,31733,410,2413
All,2001 Q3,C,Manufacturing,"Manufacture of leather and related products; Manufacture of wood and of products of wood and cork, articles of straw and plaiting materials (except furniture and toys)",1106,744,362,5,306
All,2001 Q3,C,Manufacturing,Manufacture of paper and paper products,3049,2265,784,12,567
All,2001 Q3,C,Manufacturing,Printing and reproduction of recorded media,27153,19421,7732,106,3961
All,2001 Q3,C,Manufacturing,Manufacture of coke and refined petroleum products; Manufacture of chemicals and chemical products,2441,1743,698,26,241
All,2001 Q3,C,Manufacturing,"Manufacture of pharmaceuticals, medicinal chemical and botanical products",2449,1048,1401,10,177
All,2001 Q3,C,Manufacturing,"Manufacture of rubber and plastics products (except furniture, toys, sports goods and stationery)",5300,3691,1609,20,855
All,2001 Q3,C,Manufacturing,Manufacture of other non-metallic mineral products,1923,1577,346,17,257
All,2001 Q3,C,Manufacturing,Manufacture of basic metals,1235,1047,188,9,84
All,2001 Q3,C,Manufacturing,Manufacture of fabricated metal products (except machinery and equipment),8660,6613,2047,48,1734
All,2001 Q3,C,Manufacturing,"Manufacture of computer, electronic and optical products",16989,8042,8947,90,530
All,2001 Q3,C,Manufacturing,Manufacture of electrical equipment,4158,2412,1746,10,348
All,2001 Q3,C,Manufacturing,Manufacture of machinery and equipment n.e.c.,5152,4356,796,41,1147
All,2001 Q3,C,Manufacturing,Body assembly of motor vehicles; Manufacture of other transport equipment,1698,1402,296,6,108
All,2001 Q3,C,Manufacturing,Manufacture of furniture,643,532,111,3,234
All,2001 Q3,C,Manufacturing,Other manufacturing,11807,7672,4135,27,2128
All,2001 Q3,C,Manufacturing,Repair and installation of machinery and equipment,14182,11203,2979,108,1596
All,2001 Q3,B,Mining and quarrying,Quarrying and other mining of non-metal ores,196,185,11,0,7
All,2001 Q3,D,Electricity and gas supply,Electricity and gas supply,8141,7081,1060,5,19
All,2001 Q3,E,"Sewerage, waste management and remediation services",Sewerage,452,193,259,3,39
All,2001 Q3,E,"Sewerage, waste management and remediation services","Waste collection, treatment and disposal; materials recovery",2246,1030,1216,4,226
All,2001 Q3,E,"Sewerage, waste management and remediation services",Remediation and other waste management services,83,57,26,0,12
All,2001 Q3,F,Construction,Construction sites (manual workers only),76524,70535,5989,76,964
All,2001 Q3,F,Construction,Public sector sites,33489,31627,1862,65,408
All,2001 Q3,F,Construction,Public sector building sites,14042,12951,1091,4,171
All,2001 Q3,F,Construction,Public sector civil engineering sites,19447,18676,771,61,237
All,2001 Q3,F,Construction,Private sector sites,43035,38908,4127,11,556
All,2001 Q3,F,Construction,Private sector building sites,40551,36590,3961,6,467
All,2001 Q3,F,Construction,Private sector civil engineering sites,2484,2318,166,5,89
All,2001 Q3,G,"Import/export, wholesale and retail trades",Import and export trade,507214,277850,229364,3505,99448
All,2001 Q3,G,"Import/export, wholesale and retail trades",Wholesale,70818,44358,26460,472,15785
All,2001 Q3,G,"Import/export, wholesale and retail trades",Retail trade,222833,102420,120413,2406,58037
All,2001 Q3,H,"Transportation, storage, postal and courier services",Land transport,45684,40042,5642,224,2816
All,2001 Q3,H,"Transportation, storage, postal and courier services",Water transport,9393,6072,3321,28,389
All,2001 Q3,H,"Transportation, storage, postal and courier services",Air transport,16228,6270,9958,22,112
All,2001 Q3,H,"Transportation, storage, postal and courier services",Warehousing and support services for transportation,55992,35686,20306,223,3836
All,2001 Q3,H,"Transportation, storage, postal and courier services",Postal and courier services,10669,6921,3748,137,649
All,2001 Q3,I,Accommodation and food services,Accommodation services,28387,16423,11964,216,731
All,2001 Q3,I,Accommodation and food services,Food and beverage services,195999,95441,100558,1300,11376
All,2001 Q3,J,Information and communications,Publishing,19665,11446,8219,198,1286
All,2001 Q3,J,Information and communications,"Motion picture, video and television programme production, sound recording and music publishing; Programming and broadcasting",15318,9902,5416,180,1573
All,2001 Q3,J,Information and communications,Telecommunications,26204,16997,9207,262,414
All,2001 Q3,J,Information and communications,Information technology services,25518,18189,7329,287,3698
All,2001 Q3,J,Information and communications,Information services,3137,1962,1175,30,326
All,2001 Q3,K,Financing and insurance,Financial services (except insurance and pension funding),107090,49081,58009,1298,5438
All,2001 Q3,K,Financing and insurance,Insurance,11214,4268,6946,221,150
All,2001 Q3,K,Financing and insurance,Services auxiliary to financial and insurance services,44819,21936,22883,535,9113
All,2001 Q3,L,Real estate,Real estate,82983,55933,27050,1292,9466
All,2001 Q3,M,"Professional, scientific and technical services",Legal and accounting services,33403,14903,18500,120,4670
All,2001 Q3,M,"Professional, scientific and technical services",Activities of head offices; management and management consultancy services,19789,9389,10400,133,2964
All,2001 Q3,M,"Professional, scientific and technical services","Architecture and engineering services, technical testing and analysis",27384,18978,8406,330,2377
All,2001 Q3,M,"Professional, scientific and technical services",Scientific research and development,182,95,87,4,47
All,2001 Q3,M,"Professional, scientific and technical services",Advertising and market research,14442,7586,6856,166,2911
All,2001 Q3,M,"Professional, scientific and technical services","Veterinary services; Other professional, scientific and technical services",15833,9083,6750,160,4493
All,2001 Q3,N,Administrative and support services,Rental and leasing services,1903,1288,615,20,489
All,2001 Q3,N,Administrative and support services,Employment services,6096,2385,3711,75,1265
All,2001 Q3,N,Administrative and support services,"Travel agency, reservation service and related services",18874,7914,10960,170,2059
All,2001 Q3,N,Administrative and support services,Security and investigation services,34318,29378,4940,590,165
All,2001 Q3,N,Administrative and support services,Services to buildings and landscape care,44252,15543,28709,263,1210
All,2001 Q3,N,Administrative and support services,"Office administrative, office support and other business support services",16743,8870,7873,149,3452
All,2001 Q3,P,Education,Education,123259,46225,77034,831,4106
All,2001 Q3,Q,Human health and social work services,Human health services,71028,20453,50575,1856,4441
All,2001 Q3,Q,Human health and social work services,Residential care services,18816,2802,16014,511,919
All,2001 Q3,Q,Human health and social work services,Social work services,22170,4561,17609,281,1670
All,2001 Q3,R,"Arts, entertainment and recreation",Creative and performing arts activities,2164,1392,772,32,499
All,2001 Q3,R,"Arts, entertainment and recreation","Libraries, archives, museums and other cultural activities",466,178,288,6,73
All,2001 Q3,R,"Arts, entertainment and recreation",Amusement parks and theme parks,0,0,0,0,0
All,2001 Q3,R,"Arts, entertainment and recreation",Sports and other entertainment services,0,0,0,0,0
All,2001 Q3,S,Other services,Activities of membership organisations,9383,4127,5256,116,920
All,2001 Q3,S,Other services,"Repair of motor vehicles, motorcycles, computers, personal and household goods",20218,16063,4155,168,4891
All,2001 Q3,S,Other services,Other personal services,29198,12544,16654,448,7325
All,2001 Q4,C,Manufacturing,Manufacture of food products,19399,11462,7937,131,748
All,2001 Q4,C,Manufacturing,Manufacture of beverages,3309,2656,653,12,27
All,2001 Q4,C,Manufacturing,Manufacture of tobacco products,442,349,93,3,3
All,2001 Q4,C,Manufacturing,Manufacture of textiles,14779,8805,5974,43,1268
All,2001 Q4,C,Manufacturing,Manufacture of wearing apparel,41438,11711,29727,469,2411
All,2001 Q4,C,Manufacturing,"Manufacture of leather and related products; Manufacture of wood and of products of wood and cork, articles of straw and plaiting materials (except furniture and toys)",1006,679,327,8,321
All,2001 Q4,C,Manufacturing,Manufacture of paper and paper products,2765,2034,731,3,538
All,2001 Q4,C,Manufacturing,Printing and reproduction of recorded media,28957,20184,8773,98,3996
All,2001 Q4,C,Manufacturing,Manufacture of coke and refined petroleum products; Manufacture of chemicals and chemical products,2145,1496,649,24,223
All,2001 Q4,C,Manufacturing,"Manufacture of pharmaceuticals, medicinal chemical and botanical products",2495,1096,1399,21,182
All,2001 Q4,C,Manufacturing,"Manufacture of rubber and plastics products (except furniture, toys, sports goods and stationery)",5121,3542,1579,36,930
All,2001 Q4,C,Manufacturing,Manufacture of other non-metallic mineral products,1783,1535,248,7,246
All,2001 Q4,C,Manufacturing,Manufacture of basic metals,1142,973,169,3,72
All,2001 Q4,C,Manufacturing,Manufacture of fabricated metal products (except machinery and equipment),7668,5782,1886,15,1695
All,2001 Q4,C,Manufacturing,"Manufacture of computer, electronic and optical products",16282,7770,8512,54,555
All,2001 Q4,C,Manufacturing,Manufacture of electrical equipment,3968,2235,1733,6,350
All,2001 Q4,C,Manufacturing,Manufacture of machinery and equipment n.e.c.,4259,3668,591,0,1147
All,2001 Q4,C,Manufacturing,Body assembly of motor vehicles; Manufacture of other transport equipment,1696,1403,293,9,102
All,2001 Q4,C,Manufacturing,Manufacture of furniture,549,457,92,0,220
All,2001 Q4,C,Manufacturing,Other manufacturing,11217,7238,3979,45,1992
All,2001 Q4,C,Manufacturing,Repair and installation of machinery and equipment,13756,11011,2745,56,1729
All,2001 Q4,B,Mining and quarrying,Quarrying and other mining of non-metal ores,179,171,8,0,7
All,2001 Q4,D,Electricity and gas supply,Electricity and gas supply,8096,7043,1053,8,20
All,2001 Q4,E,"Sewerage, waste management and remediation services",Sewerage,461,289,172,0,41
All,2001 Q4,E,"Sewerage, waste management and remediation services","Waste collection, treatment and disposal; materials recovery",2278,1266,1012,0,214
All,2001 Q4,E,"Sewerage, waste management and remediation services",Remediation and other waste management services,88,68,20,0,12
All,2001 Q4,F,Construction,Construction sites (manual workers only),76601,71182,5419,75,931
All,2001 Q4,F,Construction,Public sector sites,33761,31906,1855,40,405
All,2001 Q4,F,Construction,Public sector building sites,14021,13088,933,5,168
All,2001 Q4,F,Construction,Public sector civil engineering sites,19740,18818,922,35,237
All,2001 Q4,F,Construction,Private sector sites,42840,39276,3564,35,526
All,2001 Q4,F,Construction,Private sector building sites,40302,36923,3379,35,450
All,2001 Q4,F,Construction,Private sector civil engineering sites,2538,2353,185,0,76
All,2001 Q4,G,"Import/export, wholesale and retail trades",Import and export trade,499973,271051,228922,2741,98250
All,2001 Q4,G,"Import/export, wholesale and retail trades",Wholesale,65461,42601,22860,268,14522
All,2001 Q4,G,"Import/export, wholesale and retail trades",Retail trade,207713,93477,114236,1511,57037
All,2001 Q4,H,"Transportation, storage, postal and courier services",Land transport,46297,40668,5629,121,2547
All,2001 Q4,H,"Transportation, storage, postal and courier services",Water transport,8638,5579,3059,27,348
All,2001 Q4,H,"Transportation, storage, postal and courier services",Air transport,16256,6290,9966,20,108
All,2001 Q4,H,"Transportation, storage, postal and courier services",Warehousing and support services for transportation,54639,35686,18953,206,4289
All,2001 Q4,H,"Transportation, storage, postal and courier services",Postal and courier services,10218,6526,3692,164,638
All,2001 Q4,I,Accommodation and food services,Accommodation services,26815,15455,11360,192,695
All,2001 Q4,I,Accommodation and food services,Food and beverage services,194911,93312,101599,1050,11406
All,2001 Q4,J,Information and communications,Publishing,18691,10670,8021,72,1305
All,2001 Q4,J,Information and communications,"Motion picture, video and television programme production, sound recording and music publishing; Programming and broadcasting",15216,9735,5481,176,1541
All,2001 Q4,J,Information and communications,Telecommunications,26072,16765,9307,264,467
All,2001 Q4,J,Information and communications,Information technology services,25581,17994,7587,361,3830
All,2001 Q4,J,Information and communications,Information services,2531,1693,838,14,254
All,2001 Q4,K,Financing and insurance,Financial services (except insurance and pension funding),106492,49273,57219,797,5915
All,2001 Q4,K,Financing and insurance,Insurance,11489,4292,7197,111,146
All,2001 Q4,K,Financing and insurance,Services auxiliary to financial and insurance services,42918,21016,21902,568,9382
All,2001 Q4,L,Real estate,Real estate,81424,55376,26048,1094,9856
All,2001 Q4,M,"Professional, scientific and technical services",Legal and accounting services,33386,14976,18410,96,4966
All,2001 Q4,M,"Professional, scientific and technical services",Activities of head offices; management and management consultancy services,20707,9960,10747,104,3262
All,2001 Q4,M,"Professional, scientific and technical services","Architecture and engineering services, technical testing and analysis",26253,17942,8311,166,2449
All,2001 Q4,M,"Professional, scientific and technical services",Scientific research and development,288,169,119,3,48
All,2001 Q4,M,"Professional, scientific and technical services",Advertising and market research,15092,7987,7105,106,2895
All,2001 Q4,M,"Professional, scientific and technical services","Veterinary services; Other professional, scientific and technical services",16318,10145,6173,139,4642
All,2001 Q4,N,Administrative and support services,Rental and leasing services,2103,1482,621,9,517
All,2001 Q4,N,Administrative and support services,Employment services,6163,2322,3841,29,1252
All,2001 Q4,N,Administrative and support services,"Travel agency, reservation service and related services",18174,7784,10390,349,2081
All,2001 Q4,N,Administrative and support services,Security and investigation services,34056,29096,4960,539,109
All,2001 Q4,N,Administrative and support services,Services to buildings and landscape care,45424,15442,29982,204,1211
All,2001 Q4,N,Administrative and support services,"Office administrative, office support and other business support services",17072,9046,8026,235,3675
All,2001 Q4,P,Education,Education,125227,46665,78562,631,4230
All,2001 Q4,Q,Human health and social work services,Human health services,72651,20684,51967,1750,4674
All,2001 Q4,Q,Human health and social work services,Residential care services,20523,3038,17485,429,1028
All,2001 Q4,Q,Human health and social work services,Social work services,23706,4690,19016,204,1597
All,2001 Q4,R,"Arts, entertainment and recreation",Creative and performing arts activities,2100,1255,845,2,551
All,2001 Q4,R,"Arts, entertainment and recreation","Libraries, archives, museums and other cultural activities",433,162,271,9,70
All,2001 Q4,R,"Arts, entertainment and recreation",Amusement parks and theme parks,0,0,0,0,0
All,2001 Q4,R,"Arts, entertainment and recreation",Sports and other entertainment services,0,0,0,0,0
All,2001 Q4,S,Other services,Activities of membership organisations,9132,4178,4954,90,942
All,2001 Q4,S,Other services,"Repair of motor vehicles, motorcycles, computers, personal and household goods",18574,14842,3732,46,5193
All,2001 Q4,S,Other services,Other personal services,31777,12418,19359,502,7771
All,2002 Q1,C,Manufacturing,Manufacture of food products,19499,11812,7687,81,760
All,2002 Q1,C,Manufacturing,Manufacture of beverages,3311,2594,717,28,27
All,2002 Q1,C,Manufacturing,Manufacture of tobacco products,453,354,99,1,3
All,2002 Q1,C,Manufacturing,Manufacture of textiles,14473,8676,5797,46,1265
All,2002 Q1,C,Manufacturing,Manufacture of wearing apparel,39977,10659,29318,667,2186
All,2002 Q1,C,Manufacturing,"Manufacture of leather and related products; Manufacture of wood and of products of wood and cork, articles of straw and plaiting materials (except furniture and toys)",956,653,303,6,280
All,2002 Q1,C,Manufacturing,Manufacture of paper and paper products,3194,2285,909,6,589
All,2002 Q1,C,Manufacturing,Printing and reproduction of recorded media,24494,17455,7039,78,3661
All,2002 Q1,C,Manufacturing,Manufacture of coke and refined petroleum products; Manufacture of chemicals and chemical products,2694,1753,941,28,255
All,2002 Q1,C,Manufacturing,"Manufacture of pharmaceuticals, medicinal chemical and botanical products",2370,1040,1330,12,169
All,2002 Q1,C,Manufacturing,"Manufacture of rubber and plastics products (except furniture, toys, sports goods and stationery)",4984,3281,1703,15,770
All,2002 Q1,C,Manufacturing,Manufacture of other non-metallic mineral products,1823,1399,424,15,236
All,2002 Q1,C,Manufacturing,Manufacture of basic metals,1142,971,171,38,83
All,2002 Q1,C,Manufacturing,Manufacture of fabricated metal products (except machinery and equipment),7953,6031,1922,31,1721
All,2002 Q1,C,Manufacturing,"Manufacture of computer, electronic and optical products",16718,8091,8627,111,565
All,2002 Q1,C,Manufacturing,Manufacture of electrical equipment,3878,2210,1668,20,344
All,2002 Q1,C,Manufacturing,Manufacture of machinery and equipment n.e.c.,4209,3680,529,5,1020
All,2002 Q1,C,Manufacturing,Body assembly of motor vehicles; Manufacture of other transport equipment,1739,1384,355,4,124
All,2002 Q1,C,Manufacturing,Manufacture of furniture,745,622,123,0,228
All,2002 Q1,C,Manufacturing,Other manufacturing,11160,7198,3962,48,2105
All,2002 Q1,C,Manufacturing,Repair and installation of machinery and equipment,13450,10815,2635,111,1615
All,2002 Q1,B,Mining and quarrying,Quarrying and other mining of non-metal ores,160,153,7,0,7
All,2002 Q1,D,Electricity and gas supply,Electricity and gas supply,8218,7096,1122,4,21
All,2002 Q1,E,"Sewerage, waste management and remediation services",Sewerage,383,250,133,2,41
All,2002 Q1,E,"Sewerage, waste management and remediation services","Waste collection, treatment and disposal; materials recovery",2157,1084,1073,3,209
All,2002 Q1,E,"Sewerage, waste management and remediation services",Remediation and other waste management services,78,29,49,0,12
All,2002 Q1,F,Construction,Construction sites (manual workers only),76931,70973,5958,142,947
All,2002 Q1,F,Construction,Public sector sites,32074,30181,1893,138,397
All,2002 Q1,F,Construction,Public sector building sites,13484,12641,843,86,165
All,2002 Q1,F,Construction,Public sector civil engineering sites,18590,17540,1050,52,232
All,2002 Q1,F,Construction,Private sector sites,44857,40792,4065,4,550
All,2002 Q1,F,Construction,Private sector building sites,42278,38337,3941,4,474
All,2002 Q1,F,Construction,Private sector civil engineering sites,2579,2455,124,0,76
All,2002 Q1,G,"Import/export, wholesale and retail trades",Import and export trade,491280,266441,224839,4511,99880
All,2002 Q1,G,"Import/export, wholesale and retail trades",Wholesale,72784,46939,25845,406,17308
All,2002 Q1,G,"Import/export, wholesale and retail trades",Retail trade,214149,98566,115583,1677,57201
All,2002 Q1,H,"Transportation, storage, postal and courier services",Land transport,45941,39997,5944,330,2774
All,2002 Q1,H,"Transportation, storage, postal and courier services",Water transport,8801,5732,3069,17,356
All,2002 Q1,H,"Transportation, storage, postal and courier services",Air transport,16039,6257,9782,35,110
All,2002 Q1,H,"Transportation, storage, postal and courier services",Warehousing and support services for transportation,55844,35911,19933,312,4180
All,2002 Q1,H,"Transportation, storage, postal and courier services",Postal and courier services,10822,6948,3874,116,624
All,2002 Q1,I,Accommodation and food services,Accommodation services,26001,14976,11025,323,731
All,2002 Q1,I,Accommodation and food services,Food and beverage services,188825,91462,97363,1230,11539
All,2002 Q1,J,Information and communications,Publishing,18983,11273,7710,129,1243
All,2002 Q1,J,Information and communications,"Motion picture, video and television programme production, sound recording and music publishing; Programming and broadcasting",15658,9805,5853,227,1602
All,2002 Q1,J,Information and communications,Telecommunications,23979,15356,8623,235,416
All,2002 Q1,J,Information and communications,Information technology services,25629,18309,7320,393,3815
All,2002 Q1,J,Information and communications,Information services,3159,1976,1183,36,357
All,2002 Q1,K,Financing and insurance,Financial services (except insurance and pension funding),101641,46411,55230,861,5447
All,2002 Q1,K,Financing and insurance,Insurance,11387,4223,7164,203,136
All,2002 Q1,K,Financing and insurance,Services auxiliary to financial and insurance services,42037,20627,21410,716,9448
All,2002 Q1,L,Real estate,Real estate,82925,57376,25549,1439,9525
All,2002 Q1,M,"Professional, scientific and technical services",Legal and accounting services,31774,14673,17101,136,4838
All,2002 Q1,M,"Professional, scientific and technical services",Activities of head offices; management and management consultancy services,19718,9358,10360,174,3115
All,2002 Q1,M,"Professional, scientific and technical services","Architecture and engineering services, technical testing and analysis",25620,17804,7816,276,2458
All,2002 Q1,M,"Professional, scientific and technical services",Scientific research and development,271,155,116,2,49
All,2002 Q1,M,"Professional, scientific and technical services",Advertising and market research,13574,7326,6248,131,2947
All,2002 Q1,M,"Professional, scientific and technical services","Veterinary services; Other professional, scientific and technical services",15622,9178,6444,213,4885
All,2002 Q1,N,Administrative and support services,Rental and leasing services,1892,1250,642,24,469
All,2002 Q1,N,Administrative and support services,Employment services,6223,2409,3814,118,1390
All,2002 Q1,N,Administrative and support services,"Travel agency, reservation service and related services",18332,7935,10397,141,2138
All,2002 Q1,N,Administrative and support services,Security and investigation services,34217,29214,5003,612,149
All,2002 Q1,N,Administrative and support services,Services to buildings and landscape care,51553,17107,34446,149,1235
All,2002 Q1,N,Administrative and support services,"Office administrative, office support and other business support services",15608,7955,7653,152,3567
All,2002 Q1,P,Education,Education,125550,47090,78460,653,4180
All,2002 Q1,Q,Human health and social work services,Human health services,71977,20409,51568,1566,4642
All,2002 Q1,Q,Human health and social work services,Residential care services,19692,2797,16895,484,946
All,2002 Q1,Q,Human health and social work services,Social work services,23281,4871,18410,228,1672
All,2002 Q1,R,"Arts, entertainment and recreation",Creative and performing arts activities,1928,1146,782,11,464
All,2002 Q1,R,"Arts, entertainment and recreation","Libraries, archives, museums and other cultural activities",389,137,252,3,71
All,2002 Q1,R,"Arts, entertainment and recreation",Amusement parks and theme parks,0,0,0,0,0
All,2002 Q1,R,"Arts, entertainment and recreation",Sports and other entertainment services,0,0,0,0,0
All,2002 Q1,S,Other services,Activities of membership organisations,9476,4255,5221,111,959
All,2002 Q1,S,Other services,"Repair of motor vehicles, motorcycles, computers, personal and household goods",17691,14345,3346,140,5103
All,2002 Q1,S,Other services,Other personal services,31571,13505,18066,529,7864
All,2002 Q2,C,Manufacturing,Manufacture of food products,19333,11725,7608,72,783
All,2002 Q2,C,Manufacturing,Manufacture of beverages,3327,2611,716,18,35
All,2002 Q2,C,Manufacturing,Manufacture of tobacco products,461,351,110,3,3
All,2002 Q2,C,Manufacturing,Manufacture of textiles,14646,8859,5787,56,1236
All,2002 Q2,C,Manufacturing,Manufacture of wearing apparel,41130,11415,29715,525,2433
All,2002 Q2,C,Manufacturing,"Manufacture of leather and related products; Manufacture of wood and of products of wood and cork, articles of straw and plaiting materials (except furniture and toys)",1035,736,299,0,276
All,2002 Q2,C,Manufacturing,Manufacture of paper and paper products,3017,2138,879,13,531
All,2002 Q2,C,Manufacturing,Printing and reproduction of recorded media,26228,18276,7952,79,3978
All,2002 Q2,C,Manufacturing,Manufacture of coke and refined petroleum products; Manufacture of chemicals and chemical products,2524,1680,844,29,259
All,2002 Q2,C,Manufacturing,"Manufacture of pharmaceuticals, medicinal chemical and botanical products",2399,1089,1310,22,196
All,2002 Q2,C,Manufacturing,"Manufacture of rubber and plastics products (except furniture, toys, sports goods and stationery)",4974,3390,1584,46,912
All,2002 Q2,C,Manufacturing,Manufacture of other non-metallic mineral products,1794,1505,289,4,262
All,2002 Q2,C,Manufacturing,Manufacture of basic metals,1167,986,181,24,77
All,2002 Q2,C,Manufacturing,Manufacture of fabricated metal products (except machinery and equipment),8131,6309,1822,52,1732
All,2002 Q2,C,Manufacturing,"Manufacture of computer, electronic and optical products",16387,7925,8462,131,540
All,2002 Q2,C,Manufacturing,Manufacture of electrical equipment,3735,2057,1678,10,345
All,2002 Q2,C,Manufacturing,Manufacture of machinery and equipment n.e.c.,4542,3863,679,11,1137
All,2002 Q2,C,Manufacturing,Body assembly of motor vehicles; Manufacture of other transport equipment,1889,1536,353,24,123
All,2002 Q2,C,Manufacturing,Manufacture of furniture,644,547,97,11,200
All,2002 Q2,C,Manufacturing,Other manufacturing,11304,7263,4041,27,2102
All,2002 Q2,C,Manufacturing,Repair and installation of machinery and equipment,12558,10315,2243,132,1635
All,2002 Q2,B,Mining and quarrying,Quarrying and other mining of non-metal ores,135,128,7,0,6
All,2002 Q2,D,Electricity and gas supply,Electricity and gas supply,8375,7138,1237,6,21
All,2002 Q2,E,"Sewerage, waste management and remediation services",Sewerage,402,219,183,3,41
All,2002 Q2,E,"Sewerage, waste management and remediation services","Waste collection, treatment and disposal; materials recovery",1879,1063,816,2,222
All,2002 Q2,E,"Sewerage, waste management and remediation services",Remediation and other waste management services,85,35,50,0,14
All,2002 Q2,F,Construction,Construction sites (manual workers only),79193,72807,6386,57,992
All,2002 Q2,F,Construction,Public sector sites,31823,30118,1705,57,394
All,2002 Q2,F,Construction,Public sector building sites,13062,12176,886,0,157
All,2002 Q2,F,Construction,Public sector civil engineering sites,18761,17942,819,57,237
All,2002 Q2,F,Construction,Private sector sites,47370,42689,4681,0,598
All,2002 Q2,F,Construction,Private sector building sites,44204,39640,4564,0,497
All,2002 Q2,F,Construction,Private sector civil engineering sites,3166,3049,117,0,101
All,2002 Q2,G,"Import/export, wholesale and retail trades",Import and export trade,485203,260213,224990,4235,99536
All,2002 Q2,G,"Import/export, wholesale and retail trades",Wholesale,69011,44367,24644,737,16610
All,2002 Q2,G,"Import/export, wholesale and retail trades",Retail trade,215838,97574,118264,2432,58449
All,2002 Q2,H,"Transportation, storage, postal and courier services",Land transport,45772,39774,5998,242,2883
All,2002 Q2,H,"Transportation, storage, postal and courier services",Water transport,9117,5915,3202,12,387
All,2002 Q2,H,"Transportation, storage, postal and courier services",Air transport,16055,6267,9788,60,108
All,2002 Q2,H,"Transportation, storage, postal and courier services",Warehousing and support services for transportation,55914,35242,20672,359,4276
All,2002 Q2,H,"Transportation, storage, postal and courier services",Postal and courier services,11737,7756,3981,104,667
All,2002 Q2,I,Accommodation and food services,Accommodation services,26228,15140,11088,292,716
All,2002 Q2,I,Accommodation and food services,Food and beverage services,188884,89477,99407,1165,11508
All,2002 Q2,J,Information and communications,Publishing,18926,10851,8075,216,1330
All,2002 Q2,J,Information and communications,"Motion picture, video and television programme production, sound recording and music publishing; Programming and broadcasting",15501,9693,5808,115,1683
All,2002 Q2,J,Information and communications,Telecommunications,23176,14839,8337,183,502
All,2002 Q2,J,Information and communications,Information technology services,25565,18379,7186,212,4157
All,2002 Q2,J,Information and communications,Information services,2958,1526,1432,123,481
All,2002 Q2,K,Financing and insurance,Financial services (except insurance and pension funding),102230,46790,55440,888,5933
All,2002 Q2,K,Financing and insurance,Insurance,11431,4149,7282,145,143
All,2002 Q2,K,Financing and insurance,Services auxiliary to financial and insurance services,42805,21267,21538,1021,9837
All,2002 Q2,L,Real estate,Real estate,86531,58293,28238,1416,10571
All,2002 Q2,M,"Professional, scientific and technical services",Legal and accounting services,32687,14794,17893,129,5129
All,2002 Q2,M,"Professional, scientific and technical services",Activities of head offices; management and management consultancy services,19278,9925,9353,357,3600
All,2002 Q2,M,"Professional, scientific and technical services","Architecture and engineering services, technical testing and analysis",26588,18221,8367,269,2584
All,2002 Q2,M,"Professional, scientific and technical services",Scientific research and development,362,215,147,4,46
All,2002 Q2,M,"Professional, scientific and technical services",Advertising and market research,12305,6112,6193,240,2894
All,2002 Q2,M,"Professional, scientific and technical services","Veterinary services; Other professional, scientific and technical services",15217,9157,6060,133,5236
All,2002 Q2,N,Administrative and support services,Rental and leasing services,2063,1338,725,6,449
All,2002 Q2,N,Administrative and support services,Employment services,6764,3373,3391,122,1468
All,2002 Q2,N,Administrative and support services,"Travel agency, reservation service and related services",19260,8381,10879,180,2181
All,2002 Q2,N,Administrative and support services,Security and investigation services,34142,28862,5280,863,114
All,2002 Q2,N,Administrative and support services,Services to buildings and landscape care,46496,16200,30296,186,1256
All,2002 Q2,N,Administrative and support services,"Office administrative, office support and other business support services",17182,8886,8296,181,4418
All,2002 Q2,P,Education,Education,125733,46828,78905,647,4418
All,2002 Q2,Q,Human health and social work services,Human health services,72389,20541,51848,1560,4762
All,2002 Q2,Q,Human health and social work services,Residential care services,19336,3066,16270,432,954
All,2002 Q2,Q,Human health and social work services,Social work services,24999,5419,19580,129,1784
All,2002 Q2,R,"Arts, entertainment and recreation",Creative and performing arts activities,2593,1584,1009,38,630
All,2002 Q2,R,"Arts, entertainment and recreation","Libraries, archives, museums and other cultural activities",392,145,247,7,71
All,2002 Q2,R,"Arts, entertainment and recreation",Amusement parks and theme parks,0,0,0,0,0
All,2002 Q2,R,"Arts, entertainment and recreation",Sports and other entertainment services,0,0,0,0,0
All,2002 Q2,S,Other services,Activities of membership organisations,9707,4244,5463,106,937
All,2002 Q2,S,Other services,"Repair of motor vehicles, motorcycles, computers, personal and household goods",18507,14937,3570,129,5321
All,2002 Q2,S,Other services,Other personal services,32737,13315,19422,675,8227
All,2002 Q3,C,Manufacturing,Manufacture of food products,19616,11421,8195,95,739
All,2002 Q3,C,Manufacturing,Manufacture of beverages,3252,2588,664,9,28
All,2002 Q3,C,Manufacturing,Manufacture of tobacco products,470,360,110,4,3
All,2002 Q3,C,Manufacturing,Manufacture of textiles,13720,7907,5813,24,1150
All,2002 Q3,C,Manufacturing,Manufacture of wearing apparel,37880,10371,27509,691,2141
All,2002 Q3,C,Manufacturing,"Manufacture of leather and related products; Manufacture of wood and of products of wood and cork, articles of straw and plaiting materials (except furniture and toys)",1003,721,282,2,291
All,2002 Q3,C,Manufacturing,Manufacture of paper and paper products,2796,2041,755,15,534
All,2002 Q3,C,Manufacturing,Printing and reproduction of recorded media,25685,18064,7621,114,3832
All,2002 Q3,C,Manufacturing,Manufacture of coke and refined petroleum products; Manufacture of chemicals and chemical products,2156,1530,626,20,225
All,2002 Q3,C,Manufacturing,"Manufacture of pharmaceuticals, medicinal chemical and botanical products",2259,969,1290,2,178
All,2002 Q3,C,Manufacturing,"Manufacture of rubber and plastics products (except furniture, toys, sports goods and stationery)",4221,2916,1305,16,787
All,2002 Q3,C,Manufacturing,Manufacture of other non-metallic mineral products,1801,1522,279,7,248
All,2002 Q3,C,Manufacturing,Manufacture of basic metals,1313,1077,236,5,95
All,2002 Q3,C,Manufacturing,Manufacture of fabricated metal products (except machinery and equipment),6623,5196,1427,18,1568
All,2002 Q3,C,Manufacturing,"Manufacture of computer, electronic and optical products",15211,7635,7576,82,541
All,2002 Q3,C,Manufacturing,Manufacture of electrical equipment,3820,2166,1654,22,341
All,2002 Q3,C,Manufacturing,Manufacture of machinery and equipment n.e.c.,4087,3542,545,14,1030
All,2002 Q3,C,Manufacturing,Body assembly of motor vehicles; Manufacture of other transport equipment,1887,1538,349,4,136
All,2002 Q3,C,Manufacturing,Manufacture of furniture,615,511,104,4,202
All,2002 Q3,C,Manufacturing,Other manufacturing,10000,6575,3425,57,1898
All,2002 Q3,C,Manufacturing,Repair and installation of machinery and equipment,11613,9694,1919,101,1494
All,2002 Q3,B,Mining and quarrying,Quarrying and other mining of non-metal ores,133,126,7,0,6
All,2002 Q3,D,Electricity and gas supply,Electricity and gas supply,8342,7149,1193,8,17
All,2002 Q3,E,"Sewerage, waste management and remediation services",Sewerage,585,353,232,8,43
All,2002 Q3,E,"Sewerage, waste management and remediation services","Waste collection, treatment and disposal; materials recovery",2270,1147,1123,17,227
All,2002 Q3,E,"Sewerage, waste management and remediation services",Remediation and other waste management services,105,63,42,0,15
All,2002 Q3,F,Construction,Construction sites (manual workers only),70376,65215,5161,61,959
All,2002 Q3,F,Construction,Public sector sites,28645,26948,1697,44,381
All,2002 Q3,F,Construction,Public sector building sites,9638,8968,670,3,141
All,2002 Q3,F,Construction,Public sector civil engineering sites,19007,17980,1027,41,240
All,2002 Q3,F,Construction,Private sector sites,41731,38267,3464,17,578
All,2002 Q3,F,Construction,Private sector building sites,39022,35662,3360,17,491
All,2002 Q3,F,Construction,Private sector civil engineering sites,2709,2605,104,0,87
All,2002 Q3,G,"Import/export, wholesale and retail trades",Import and export trade,512419,279424,232995,3785,108515
All,2002 Q3,G,"Import/export, wholesale and retail trades",Wholesale,65921,41967,23954,367,15930
All,2002 Q3,G,"Import/export, wholesale and retail trades",Retail trade,218873,100324,118549,1584,59574
All,2002 Q3,H,"Transportation, storage, postal and courier services",Land transport,45639,39731,5908,295,2991
All,2002 Q3,H,"Transportation, storage, postal and courier services",Water transport,8938,5813,3125,9,351
All,2002 Q3,H,"Transportation, storage, postal and courier services",Air transport,16879,6654,10225,121,114
All,2002 Q3,H,"Transportation, storage, postal and courier services",Warehousing and support services for transportation,56957,36280,20677,241,4077
All,2002 Q3,H,"Transportation, storage, postal and courier services",Postal and courier services,10966,7242,3724,85,673
All,2002 Q3,I,Accommodation and food services,Accommodation services,26329,15354,10975,233,742
All,2002 Q3,I,Accommodation and food services,Food and beverage services,187229,88190,99039,1142,11682
All,2002 Q3,J,Information and communications,Publishing,20510,11790,8720,115,1364
All,2002 Q3,J,Information and communications,"Motion picture, video and television programme production, sound recording and music publishing; Programming and broadcasting",15796,10088,5708,151,1712
All,2002 Q3,J,Information and communications,Telecommunications,22500,14438,8062,333,447
All,2002 Q3,J,Information and communications,Information technology services,25869,18485,7384,305,4265
All,2002 Q3,J,Information and communications,Information services,2357,1383,974,25,397
All,2002 Q3,K,Financing and insurance,Financial services (except insurance and pension funding),101306,46315,54991,920,5433
All,2002 Q3,K,Financing and insurance,Insurance,11506,4317,7189,161,142
All,2002 Q3,K,Financing and insurance,Services auxiliary to financial and insurance services,39693,19398,20295,828,9784
All,2002 Q3,L,Real estate,Real estate,84036,57203,26833,1025,9862
All,2002 Q3,M,"Professional, scientific and technical services",Legal and accounting services,31935,14804,17131,141,5047
All,2002 Q3,M,"Professional, scientific and technical services",Activities of head offices; management and management consultancy services,21008,11117,9891,351,3656
All,2002 Q3,M,"Professional, scientific and technical services","Architecture and engineering services, technical testing and analysis",27122,18741,8381,174,2323
All,2002 Q3,M,"Professional, scientific and technical services",Scientific research and development,447,290,157,6,52
All,2002 Q3,M,"Professional, scientific and technical services",Advertising and market research,13426,7136,6290,141,3091
All,2002 Q3,M,"Professional, scientific and technical services","Veterinary services; Other professional, scientific and technical services",13348,8052,5296,161,4697
All,2002 Q3,N,Administrative and support services,Rental and leasing services,1966,1238,728,16,477
All,2002 Q3,N,Administrative and support services,Employment services,6608,2652,3956,7,1397
All,2002 Q3,N,Administrative and support services,"Travel agency, reservation service and related services",16817,7393,9424,92,2205
All,2002 Q3,N,Administrative and support services,Security and investigation services,34900,28985,5915,501,180
All,2002 Q3,N,Administrative and support services,Services to buildings and landscape care,50952,16937,34015,291,1310
All,2002 Q3,N,Administrative and support services,"Office administrative, office support and other business support services",16305,8658,7647,174,3999
All,2002 Q3,P,Education,Education,125662,46583,79079,662,4601
All,2002 Q3,Q,Human health and social work services,Human health services,73485,20827,52658,1406,4791
All,2002 Q3,Q,Human health and social work services,Residential care services,22320,3342,18978,473,1113
All,2002 Q3,Q,Human health and social work services,Social work services,23667,4906,18761,190,1619
All,2002 Q3,R,"Arts, entertainment and recreation",Creative and performing arts activities,2207,1355,852,11,573
All,2002 Q3,R,"Arts, entertainment and recreation","Libraries, archives, museums and other cultural activities",418,156,262,2,73
All,2002 Q3,R,"Arts, entertainment and recreation",Amusement parks and theme parks,0,0,0,0,0
All,2002 Q3,R,"Arts, entertainment and recreation",Sports and other entertainment services,0,0,0,0,0
All,2002 Q3,S,Other services,Activities of membership organisations,9417,4140,5277,112,961
All,2002 Q3,S,Other services,"Repair of motor vehicles, motorcycles, computers, personal and household goods",18946,15434,3512,83,5176
All,2002 Q3,S,Other services,Other personal services,32528,13443,19085,389,8021
All,2002 Q4,C,Manufacturing,Manufacture of food products,18895,10867,8028,73,739
All,2002 Q4,C,Manufacturing,Manufacture of beverages,3202,2471,731,19,28
All,2002 Q4,C,Manufacturing,Manufacture of tobacco products,467,357,110,0,3
All,2002 Q4,C,Manufacturing,Manufacture of textiles,13601,7886,5715,9,1180
All,2002 Q4,C,Manufacturing,Manufacture of wearing apparel,35102,9958,25144,386,2291
All,2002 Q4,C,Manufacturing,"Manufacture of leather and related products; Manufacture of wood and of products of wood and cork, articles of straw and plaiting materials (except furniture and toys)",865,637,228,1,282
All,2002 Q4,C,Manufacturing,Manufacture of paper and paper products,2816,2128,688,1,539
All,2002 Q4,C,Manufacturing,Printing and reproduction of recorded media,24449,17276,7173,93,3788
All,2002 Q4,C,Manufacturing,Manufacture of coke and refined petroleum products; Manufacture of chemicals and chemical products,2161,1530,631,11,235
All,2002 Q4,C,Manufacturing,"Manufacture of pharmaceuticals, medicinal chemical and botanical products",2436,1028,1408,9,184
All,2002 Q4,C,Manufacturing,"Manufacture of rubber and plastics products (except furniture, toys, sports goods and stationery)",4498,3056,1442,2,851
All,2002 Q4,C,Manufacturing,Manufacture of other non-metallic mineral products,1885,1523,362,0,261
All,2002 Q4,C,Manufacturing,Manufacture of basic metals,1362,1129,233,1,84
All,2002 Q4,C,Manufacturing,Manufacture of fabricated metal products (except machinery and equipment),6930,5398,1532,16,1689
All,2002 Q4,C,Manufacturing,"Manufacture of computer, electronic and optical products",14442,6913,7529,37,473
All,2002 Q4,C,Manufacturing,Manufacture of electrical equipment,3740,2021,1719,19,336
All,2002 Q4,C,Manufacturing,Manufacture of machinery and equipment n.e.c.,4015,3484,531,27,967
All,2002 Q4,C,Manufacturing,Body assembly of motor vehicles; Manufacture of other transport equipment,1834,1512,322,1,116
All,2002 Q4,C,Manufacturing,Manufacture of furniture,534,452,82,0,194
All,2002 Q4,C,Manufacturing,Other manufacturing,10632,6722,3910,42,1992
All,2002 Q4,C,Manufacturing,Repair and installation of machinery and equipment,11740,9857,1883,98,1595
All,2002 Q4,B,Mining and quarrying,Quarrying and other mining of non-metal ores,117,111,6,0,6
All,2002 Q4,D,Electricity and gas supply,Electricity and gas supply,8406,7194,1212,4,17
All,2002 Q4,E,"Sewerage, waste management and remediation services",Sewerage,415,216,199,0,45
All,2002 Q4,E,"Sewerage, waste management and remediation services","Waste collection, treatment and disposal; materials recovery",2160,1036,1124,0,226
All,2002 Q4,E,"Sewerage, waste management and remediation services",Remediation and other waste management services,74,32,42,0,15
All,2002 Q4,F,Construction,Construction sites (manual workers only),66393,61876,4517,28,949
All,2002 Q4,F,Construction,Public sector sites,28810,27348,1462,28,391
All,2002 Q4,F,Construction,Public sector building sites,10724,10017,707,0,145
All,2002 Q4,F,Construction,Public sector civil engineering sites,18086,17331,755,28,246
All,2002 Q4,F,Construction,Private sector sites,37583,34528,3055,0,558
All,2002 Q4,F,Construction,Private sector building sites,34562,31641,2921,0,477
All,2002 Q4,F,Construction,Private sector civil engineering sites,3021,2887,134,0,81
All,2002 Q4,G,"Import/export, wholesale and retail trades",Import and export trade,498314,269951,228363,2986,103267
All,2002 Q4,G,"Import/export, wholesale and retail trades",Wholesale,64754,40978,23776,444,15407
All,2002 Q4,G,"Import/export, wholesale and retail trades",Retail trade,208386,92906,115480,1472,57493
All,2002 Q4,H,"Transportation, storage, postal and courier services",Land transport,45045,39094,5951,224,3007
All,2002 Q4,H,"Transportation, storage, postal and courier services",Water transport,8761,5691,3070,12,364
All,2002 Q4,H,"Transportation, storage, postal and courier services",Air transport,16465,6436,10029,107,113
All,2002 Q4,H,"Transportation, storage, postal and courier services",Warehousing and support services for transportation,57077,36425,20652,234,4176
All,2002 Q4,H,"Transportation, storage, postal and courier services",Postal and courier services,10264,6650,3614,127,681
All,2002 Q4,I,Accommodation and food services,Accommodation services,25994,14996,10998,215,736
All,2002 Q4,I,Accommodation and food services,Food and beverage services,182353,85092,97261,858,11644
All,2002 Q4,J,Information and communications,Publishing,20042,11361,8681,92,1419
All,2002 Q4,J,Information and communications,"Motion picture, video and television programme production, sound recording and music publishing; Programming and broadcasting",15705,9970,5735,99,1804
All,2002 Q4,J,Information and communications,Telecommunications,19241,11756,7485,149,421
All,2002 Q4,J,Information and communications,Information technology services,31000,22920,8080,179,4657
All,2002 Q4,J,Information and communications,Information services,2206,1434,772,11,434
All,2002 Q4,K,Financing and insurance,Financial services (except insurance and pension funding),99286,45367,53919,1060,5745
All,2002 Q4,K,Financing and insurance,Insurance,11578,4300,7278,110,144
All,2002 Q4,K,Financing and insurance,Services auxiliary to financial and insurance services,41131,19995,21136,440,10141
All,2002 Q4,L,Real estate,Real estate,87786,60413,27373,1475,10499
All,2002 Q4,M,"Professional, scientific and technical services",Legal and accounting services,34893,15765,19128,186,5157
All,2002 Q4,M,"Professional, scientific and technical services",Activities of head offices; management and management consultancy services,21877,11059,10818,254,3991
All,2002 Q4,M,"Professional, scientific and technical services","Architecture and engineering services, technical testing and analysis",26687,17981,8706,226,2564
All,2002 Q4,M,"Professional, scientific and technical services",Scientific research and development,454,297,157,7,46
All,2002 Q4,M,"Professional, scientific and technical services",Advertising and market research,13278,7308,5970,54,3069
All,2002 Q4,M,"Professional, scientific and technical services","Veterinary services; Other professional, scientific and technical services",15602,9094,6508,125,5274
All,2002 Q4,N,Administrative and support services,Rental and leasing services,1928,1245,683,7,562
All,2002 Q4,N,Administrative and support services,Employment services,7793,3127,4666,34,1614
All,2002 Q4,N,Administrative and support services,"Travel agency, reservation service and related services",17296,7429,9867,135,2214
All,2002 Q4,N,Administrative and support services,Security and investigation services,35110,29300,5810,370,166
All,2002 Q4,N,Administrative and support services,Services to buildings and landscape care,50459,16833,33626,228,1348
All,2002 Q4,N,Administrative and support services,"Office administrative, office support and other business support services",18532,9737,8795,98,4576
All,2002 Q4,P,Education,Education,125722,46606,79116,518,4725
All,2002 Q4,P,Human health and social work services,Human health services,73788,20929,52859,1172,4795
All,2002 Q4,P,Human health and social work services,Residential care services,23633,3184,20449,476,1125
All,2002 Q4,P,Human health and social work services,Social work services,24586,5247,19339,255,1707
All,2002 Q4,R,"Arts, entertainment and recreation",Creative and performing arts activities,1890,1136,754,1,531
All,2002 Q4,R,"Arts, entertainment and recreation","Libraries, archives, museums and other cultural activities",454,172,282,4,75
All,2002 Q4,R,"Arts, entertainment and recreation",Amusement parks and theme parks,0,0,0,0,0
All,2002 Q4,R,"Arts, entertainment and recreation",Sports and other entertainment services,0,0,0,0,0
All,2002 Q4,S,Other services,Activities of membership organisations,9575,4204,5371,106,955
All,2002 Q4,S,Other services,"Repair of motor vehicles, motorcycles, computers, personal and household goods",18608,15306,3302,98,5497
All,2002 Q4,S,Other services,Other personal services,34082,13546,20536,266,8287
All,2003 Q1,C,Manufacturing,Manufacture of food products,19151,11130,8021,74,743
All,2003 Q1,C,Manufacturing,Manufacture of beverages,3233,2400,833,20,28
All,2003 Q1,C,Manufacturing,Manufacture of tobacco products,470,361,109,2,3
All,2003 Q1,C,Manufacturing,Manufacture of textiles,13788,8117,5671,15,1204
All,2003 Q1,C,Manufacturing,Manufacture of wearing apparel,33283,9111,24172,475,1993
All,2003 Q1,C,Manufacturing,"Manufacture of leather and related products; Manufacture of wood and of products of wood and cork, articles of straw and plaiting materials (except furniture and toys)",947,702,245,5,309
All,2003 Q1,C,Manufacturing,Manufacture of paper and paper products,2426,1799,627,11,521
All,2003 Q1,C,Manufacturing,Printing and reproduction of recorded media,23442,16545,6897,57,3514
All,2003 Q1,C,Manufacturing,Manufacture of coke and refined petroleum products; Manufacture of chemicals and chemical products,2151,1647,504,4,254
All,2003 Q1,C,Manufacturing,"Manufacture of pharmaceuticals, medicinal chemical and botanical products",2506,1167,1339,11,195
All,2003 Q1,C,Manufacturing,"Manufacture of rubber and plastics products (except furniture, toys, sports goods and stationery)",3841,2510,1331,24,704
All,2003 Q1,C,Manufacturing,Manufacture of other non-metallic mineral products,1594,1318,276,10,289
All,2003 Q1,C,Manufacturing,Manufacture of basic metals,1249,1032,217,0,80
All,2003 Q1,C,Manufacturing,Manufacture of fabricated metal products (except machinery and equipment),6317,4901,1416,16,1565
All,2003 Q1,C,Manufacturing,"Manufacture of computer, electronic and optical products",13237,6467,6770,37,446
All,2003 Q1,C,Manufacturing,Manufacture of electrical equipment,3687,1928,1759,7,367
All,2003 Q1,C,Manufacturing,Manufacture of machinery and equipment n.e.c.,3444,2989,455,3,873
All,2003 Q1,C,Manufacturing,Body assembly of motor vehicles; Manufacture of other transport equipment,2071,1718,353,31,137
All,2003 Q1,C,Manufacturing,Manufacture of furniture,661,525,136,5,226
All,2003 Q1,C,Manufacturing,Other manufacturing,10364,6697,3667,72,1915
All,2003 Q1,C,Manufacturing,Repair and installation of machinery and equipment,11856,9617,2239,48,1500
All,2003 Q1,B,Mining and quarrying,Quarrying and other mining of non-metal ores,112,108,4,0,6
All,2003 Q1,D,Electricity and gas supply,Electricity and gas supply,8426,7211,1215,5,17
All,2003 Q1,E,"Sewerage, waste management and remediation services",Sewerage,294,189,105,0,39
All,2003 Q1,E,"Sewerage, waste management and remediation services","Waste collection, treatment and disposal; materials recovery",2311,923,1388,1,218
All,2003 Q1,E,"Sewerage, waste management and remediation services",Remediation and other waste management services,100,49,51,0,15
All,2003 Q1,F,Construction,Construction sites (manual workers only),72311,67363,4948,26,1031
All,2003 Q1,F,Construction,Public sector sites,33739,32232,1507,24,450
All,2003 Q1,F,Construction,Public sector building sites,16518,15671,847,1,191
All,2003 Q1,F,Construction,Public sector civil engineering sites,17221,16561,660,23,259
All,2003 Q1,F,Construction,Private sector sites,38572,35131,3441,2,581
All,2003 Q1,F,Construction,Private sector building sites,35489,32207,3282,2,490
All,2003 Q1,F,Construction,Private sector civil engineering sites,3083,2924,159,0,91
All,2003 Q1,G,"Import/export, wholesale and retail trades",Import and export trade,497690,267012,230678,4028,100544
All,2003 Q1,G,"Import/export, wholesale and retail trades",Wholesale,64615,40743,23872,347,14868
All,2003 Q1,G,"Import/export, wholesale and retail trades",Retail trade,207285,91811,115474,1081,55614
All,2003 Q1,H,"Transportation, storage, postal and courier services",Land transport,45697,39763,5934,298,2923
All,2003 Q1,H,"Transportation, storage, postal and courier services",Water transport,8913,5660,3253,38,336
All,2003 Q1,H,"Transportation, storage, postal and courier services",Air transport,16809,6513,10296,23,113
All,2003 Q1,H,"Transportation, storage, postal and courier services",Warehousing and support services for transportation,54632,34927,19705,227,4143
All,2003 Q1,H,"Transportation, storage, postal and courier services",Postal and courier services,10808,6968,3840,186,628
All,2003 Q1,I,Accommodation and food services,Accommodation services,25399,14509,10890,44,701
All,2003 Q1,I,Accommodation and food services,Food and beverage services,174304,83721,90583,788,11225
All,2003 Q1,J,Information and communications,Publishing,19612,10927,8685,180,1256
All,2003 Q1,J,Information and communications,"Motion picture, video and television programme production, sound recording and music publishing; Programming and broadcasting",14928,9556,5372,133,1602
All,2003 Q1,J,Information and communications,Telecommunications,15897,9242,6655,75,357
All,2003 Q1,J,Information and communications,Information technology services,29150,21707,7443,252,4197
All,2003 Q1,J,Information and communications,Information services,2503,1263,1240,4,420
All,2003 Q1,K,Financing and insurance,Financial services (except insurance and pension funding),97908,44387,53521,1119,5100
All,2003 Q1,K,Financing and insurance,Insurance,11531,4299,7232,85,146
All,2003 Q1,K,Financing and insurance,Services auxiliary to financial and insurance services,39866,19458,20408,843,9959
All,2003 Q1,L,Real estate,Real estate,84694,57633,27061,467,9638
All,2003 Q1,M,"Professional, scientific and technical services",Legal and accounting services,33791,15019,18772,141,5099
All,2003 Q1,M,"Professional, scientific and technical services",Activities of head offices; management and management consultancy services,19498,9419,10079,178,3568
All,2003 Q1,M,"Professional, scientific and technical services","Architecture and engineering services, technical testing and analysis",24601,17232,7369,201,2398
All,2003 Q1,M,"Professional, scientific and technical services",Scientific research and development,444,275,169,8,38
All,2003 Q1,M,"Professional, scientific and technical services",Advertising and market research,12110,6952,5158,182,3106
All,2003 Q1,M,"Professional, scientific and technical services","Veterinary services; Other professional, scientific and technical services",14748,8507,6241,201,4947
All,2003 Q1,N,Administrative and support services,Rental and leasing services,1679,977,702,19,500
All,2003 Q1,N,Administrative and support services,Employment services,7373,2680,4693,104,1533
All,2003 Q1,N,Administrative and support services,"Travel agency, reservation service and related services",18402,7808,10594,88,2181
All,2003 Q1,N,Administrative and support services,Security and investigation services,34892,28772,6120,287,128
All,2003 Q1,N,Administrative and support services,Services to buildings and landscape care,51451,17434,34017,188,1286
All,2003 Q1,N,Administrative and support services,"Office administrative, office support and other business support services",15805,8188,7617,184,3857
All,2003 Q1,P,Education,Education,127345,47412,79933,513,4672
All,2003 Q1,Q,Human health and social work services,Human health services,72541,20824,51717,1200,4741
All,2003 Q1,Q,Human health and social work services,Residential care services,22122,3045,19077,345,1022
All,2003 Q1,Q,Human health and social work services,Social work services,25895,5447,20448,191,1750
All,2003 Q1,R,"Arts, entertainment and recreation",Creative and performing arts activities,1824,1026,798,37,498
All,2003 Q1,R,"Arts, entertainment and recreation","Libraries, archives, museums and other cultural activities",427,143,284,4,69
All,2003 Q1,R,"Arts, entertainment and recreation",Amusement parks and theme parks,0,0,0,0,0
All,2003 Q1,R,"Arts, entertainment and recreation",Sports and other entertainment services,0,0,0,0,0
All,2003 Q1,S,Other services,Activities of membership organisations,8966,4028,4938,97,916
All,2003 Q1,S,Other services,"Repair of motor vehicles, motorcycles, computers, personal and household goods",16715,13873,2842,79,5103
All,2003 Q1,S,Other services,Other personal services,32340,13263,19077,310,8140
All,2003 Q2,C,Manufacturing,Manufacture of food products,17521,10543,6978,56,739
All,2003 Q2,C,Manufacturing,Manufacture of beverages,3298,2519,779,22,26
All,2003 Q2,C,Manufacturing,Manufacture of tobacco products,466,359,107,1,3
All,2003 Q2,C,Manufacturing,Manufacture of textiles,12369,7173,5196,55,1078
All,2003 Q2,C,Manufacturing,Manufacture of wearing apparel,33263,9194,24069,454,1701
All,2003 Q2,C,Manufacturing,"Manufacture of leather and related products; Manufacture of wood and of products of wood and cork, articles of straw and plaiting materials (except furniture and toys)",954,658,296,6,278
All,2003 Q2,C,Manufacturing,Manufacture of paper and paper products,2583,1861,722,22,502
All,2003 Q2,C,Manufacturing,Printing and reproduction of recorded media,24134,16828,7306,163,3487
All,2003 Q2,C,Manufacturing,Manufacture of coke and refined petroleum products; Manufacture of chemicals and chemical products,2035,1368,667,4,252
All,2003 Q2,C,Manufacturing,"Manufacture of pharmaceuticals, medicinal chemical and botanical products",2752,1194,1558,16,201
All,2003 Q2,C,Manufacturing,"Manufacture of rubber and plastics products (except furniture, toys, sports goods and stationery)",3867,2564,1303,31,658
All,2003 Q2,C,Manufacturing,Manufacture of other non-metallic mineral products,1465,1190,275,0,231
All,2003 Q2,C,Manufacturing,Manufacture of basic metals,1255,1056,199,14,103
All,2003 Q2,C,Manufacturing,Manufacture of fabricated metal products (except machinery and equipment),6432,4769,1663,10,1416
All,2003 Q2,C,Manufacturing,"Manufacture of computer, electronic and optical products",12829,6394,6435,84,495
All,2003 Q2,C,Manufacturing,Manufacture of electrical equipment,3426,1845,1581,29,331
All,2003 Q2,C,Manufacturing,Manufacture of machinery and equipment n.e.c.,3094,2722,372,13,818
All,2003 Q2,C,Manufacturing,Body assembly of motor vehicles; Manufacture of other transport equipment,1787,1440,347,2,131
All,2003 Q2,C,Manufacturing,Manufacture of furniture,473,382,91,0,183
All,2003 Q2,C,Manufacturing,Other manufacturing,9233,5826,3407,46,1697
All,2003 Q2,C,Manufacturing,Repair and installation of machinery and equipment,11259,9195,2064,98,1465
All,2003 Q2,B,Mining and quarrying,Quarrying and other mining of non-metal ores,107,102,5,0,6
All,2003 Q2,D,Electricity and gas supply,Electricity and gas supply,8369,7141,1228,7,17
All,2003 Q2,E,"Sewerage, waste management and remediation services",Sewerage,146,46,100,0,39
All,2003 Q2,E,"Sewerage, waste management and remediation services","Waste collection, treatment and disposal; materials recovery",2339,975,1364,0,224
All,2003 Q2,E,"Sewerage, waste management and remediation services",Remediation and other waste management services,156,113,43,0,14
All,2003 Q2,F,Construction,Construction sites (manual workers only),69938,65494,4444,27,1050
All,2003 Q2,F,Construction,Public sector sites,35423,33671,1752,27,458
All,2003 Q2,F,Construction,Public sector building sites,17421,16333,1088,0,190
All,2003 Q2,F,Construction,Public sector civil engineering sites,18002,17338,664,27,268
All,2003 Q2,F,Construction,Private sector sites,34515,31823,2692,0,592
All,2003 Q2,F,Construction,Private sector building sites,32199,29608,2591,0,501
All,2003 Q2,F,Construction,Private sector civil engineering sites,2316,2215,101,0,91
All,2003 Q2,G,"Import/export, wholesale and retail trades",Import and export trade,491864,262121,229743,4323,97850
All,2003 Q2,G,"Import/export, wholesale and retail trades",Wholesale,64203,41165,23038,536,15334
All,2003 Q2,G,"Import/export, wholesale and retail trades",Retail trade,206594,90207,116387,1511,55515
All,2003 Q2,H,"Transportation, storage, postal and courier services",Land transport,44596,38784,5812,195,2711
All,2003 Q2,H,"Transportation, storage, postal and courier services",Water transport,8840,5567,3273,29,308
All,2003 Q2,H,"Transportation, storage, postal and courier services",Air transport,16576,6435,10141,1,108
All,2003 Q2,H,"Transportation, storage, postal and courier services",Warehousing and support services for transportation,55011,34960,20051,254,3950
All,2003 Q2,H,"Transportation, storage, postal and courier services",Postal and courier services,11532,7549,3983,260,616
All,2003 Q2,I,Accommodation and food services,Accommodation services,23110,13427,9683,142,679
All,2003 Q2,I,Accommodation and food services,Food and beverage services,169852,80174,89678,989,11012
All,2003 Q2,J,Information and communications,Publishing,18520,10285,8235,113,1341
All,2003 Q2,J,Information and communications,"Motion picture, video and television programme production, sound recording and music publishing; Programming and broadcasting",15324,9748,5576,197,1699
All,2003 Q2,J,Information and communications,Telecommunications,16952,9998,6954,159,363
All,2003 Q2,J,Information and communications,Information technology services,29706,22214,7492,294,4307
All,2003 Q2,J,Information and communications,Information services,2684,1456,1228,68,341
All,2003 Q2,K,Financing and insurance,Financial services (except insurance and pension funding),92510,41950,50560,955,4678
All,2003 Q2,K,Financing and insurance,Insurance,11403,4147,7256,127,134
All,2003 Q2,K,Financing and insurance,Services auxiliary to financial and insurance services,39063,19146,19917,1535,9398
All,2003 Q2,L,Real estate,Real estate,86620,59297,27323,1360,8425
All,2003 Q2,M,"Professional, scientific and technical services",Legal and accounting services,33916,14751,19165,166,5053
All,2003 Q2,M,"Professional, scientific and technical services",Activities of head offices; management and management consultancy services,18231,9279,8952,444,3615
All,2003 Q2,M,"Professional, scientific and technical services","Architecture and engineering services, technical testing and analysis",25653,17898,7755,236,2372
All,2003 Q2,M,"Professional, scientific and technical services",Scientific research and development,450,296,154,7,39
All,2003 Q2,M,"Professional, scientific and technical services",Advertising and market research,13060,7401,5659,309,3138
All,2003 Q2,M,"Professional, scientific and technical services","Veterinary services; Other professional, scientific and technical services",15963,9228,6735,269,4701
All,2003 Q2,N,Administrative and support services,Rental and leasing services,1961,1206,755,14,512
All,2003 Q2,N,Administrative and support services,Employment services,7384,2825,4559,126,1309
All,2003 Q2,N,Administrative and support services,"Travel agency, reservation service and related services",15768,6719,9049,201,2022
All,2003 Q2,N,Administrative and support services,Security and investigation services,33499,27699,5800,294,214
All,2003 Q2,N,Administrative and support services,Services to buildings and landscape care,51801,16571,35230,193,1317
All,2003 Q2,N,Administrative and support services,"Office administrative, office support and other business support services",15015,7632,7383,125,3801
All,2003 Q2,P,Education,Education,129285,48563,80722,656,4684
All,2003 Q2,Q,Human health and social work services,Human health services,73460,21108,52352,1209,4886
All,2003 Q2,Q,Human health and social work services,Residential care services,22932,3273,19659,343,1085
All,2003 Q2,Q,Human health and social work services,Social work services,26314,5094,21220,180,1657
All,2003 Q2,R,"Arts, entertainment and recreation",Creative and performing arts activities,2113,1386,727,12,592
All,2003 Q2,R,"Arts, entertainment and recreation","Libraries, archives, museums and other cultural activities",470,158,312,13,78
All,2003 Q2,R,"Arts, entertainment and recreation",Amusement parks and theme parks,0,0,0,0,0
All,2003 Q2,R,"Arts, entertainment and recreation",Sports and other entertainment services,0,0,0,0,0
All,2003 Q2,S,Other services,Activities of membership organisations,8740,3904,4836,116,870
All,2003 Q2,S,Other services,"Repair of motor vehicles, motorcycles, computers, personal and household goods",16154,13291,2863,120,4877
All,2003 Q2,S,Other services,Other personal services,31489,12672,18817,493,7872
All,2003 Q3,C,Manufacturing,Manufacture of food products,19259,11125,8134,114,771
All,2003 Q3,C,Manufacturing,Manufacture of beverages,3252,2459,793,22,23
All,2003 Q3,C,Manufacturing,Manufacture of tobacco products,497,371,126,5,3
All,2003 Q3,C,Manufacturing,Manufacture of textiles,11774,6851,4923,16,1104
All,2003 Q3,C,Manufacturing,Manufacture of wearing apparel,33327,8297,25030,158,1823
All,2003 Q3,C,Manufacturing,"Manufacture of leather and related products; Manufacture of wood and of products of wood and cork, articles of straw and plaiting materials (except furniture and toys)",927,628,299,2,243
All,2003 Q3,C,Manufacturing,Manufacture of paper and paper products,2389,1722,667,5,483
All,2003 Q3,C,Manufacturing,Printing and reproduction of recorded media,23128,16238,6890,103,3417
All,2003 Q3,C,Manufacturing,Manufacture of coke and refined petroleum products; Manufacture of chemicals and chemical products,2349,1621,728,9,250
All,2003 Q3,C,Manufacturing,"Manufacture of pharmaceuticals, medicinal chemical and botanical products",2508,1131,1377,13,221
All,2003 Q3,C,Manufacturing,"Manufacture of rubber and plastics products (except furniture, toys, sports goods and stationery)",3795,2562,1233,6,658
All,2003 Q3,C,Manufacturing,Manufacture of other non-metallic mineral products,1444,1177,267,0,215
All,2003 Q3,C,Manufacturing,Manufacture of basic metals,1460,1187,273,10,107
All,2003 Q3,C,Manufacturing,Manufacture of fabricated metal products (except machinery and equipment),5538,4220,1318,9,1278
All,2003 Q3,C,Manufacturing,"Manufacture of computer, electronic and optical products",12306,6317,5989,136,458
All,2003 Q3,C,Manufacturing,Manufacture of electrical equipment,3446,1771,1675,10,329
All,2003 Q3,C,Manufacturing,Manufacture of machinery and equipment n.e.c.,3584,3031,553,18,906
All,2003 Q3,C,Manufacturing,Body assembly of motor vehicles; Manufacture of other transport equipment,1924,1587,337,3,136
All,2003 Q3,C,Manufacturing,Manufacture of furniture,933,631,302,1,230
All,2003 Q3,C,Manufacturing,Other manufacturing,9606,6229,3377,73,1803
All,2003 Q3,C,Manufacturing,Repair and installation of machinery and equipment,11055,9206,1849,76,1519
All,2003 Q3,B,Mining and quarrying,Quarrying and other mining of non-metal ores,105,100,5,0,6
All,2003 Q3,D,Electricity and gas supply,Electricity and gas supply,8314,7086,1228,6,16
All,2003 Q3,E,"Sewerage, waste management and remediation services",Sewerage,190,104,86,0,42
All,2003 Q3,E,"Sewerage, waste management and remediation services","Waste collection, treatment and disposal; materials recovery",2730,1250,1480,15,220
All,2003 Q3,E,"Sewerage, waste management and remediation services",Remediation and other waste management services,83,73,10,0,15
All,2003 Q3,F,Construction,Construction sites (manual workers only),70625,65814,4811,26,1075
All,2003 Q3,F,Construction,Public sector sites,33038,31395,1643,26,476
All,2003 Q3,F,Construction,Public sector building sites,15327,14493,834,0,191
All,2003 Q3,F,Construction,Public sector civil engineering sites,17711,16902,809,26,285
All,2003 Q3,F,Construction,Private sector sites,37587,34419,3168,0,599
All,2003 Q3,F,Construction,Private sector building sites,34134,31145,2989,0,497
All,2003 Q3,F,Construction,Private sector civil engineering sites,3453,3274,179,0,102
All,2003 Q3,G,"Import/export, wholesale and retail trades",Import and export trade,486399,258441,227958,4807,96270
All,2003 Q3,G,"Import/export, wholesale and retail trades",Wholesale,66062,42045,24017,439,14803
All,2003 Q3,G,"Import/export, wholesale and retail trades",Retail trade,204917,89276,115641,1624,55580
All,2003 Q3,H,"Transportation, storage, postal and courier services",Land transport,45064,39311,5753,181,2695
All,2003 Q3,H,"Transportation, storage, postal and courier services",Water transport,8655,5543,3112,11,297
All,2003 Q3,H,"Transportation, storage, postal and courier services",Air transport,16909,6626,10283,93,117
All,2003 Q3,H,"Transportation, storage, postal and courier services",Warehousing and support services for transportation,54507,33631,20876,239,4103
All,2003 Q3,H,"Transportation, storage, postal and courier services",Postal and courier services,11378,7677,3701,135,604
All,2003 Q3,I,Accommodation and food services,Accommodation services,23819,13737,10082,367,673
All,2003 Q3,I,Accommodation and food services,Food and beverage services,172015,79664,92351,1332,11167
All,2003 Q3,J,Information and communications,Publishing,21073,11839,9234,157,1473
All,2003 Q3,J,Information and communications,"Motion picture, video and television programme production, sound recording and music publishing; Programming and broadcasting",15397,9896,5501,160,1662
All,2003 Q3,J,Information and communications,Telecommunications,16985,9943,7042,122,349
All,2003 Q3,J,Information and communications,Information technology services,27759,20537,7222,600,4429
All,2003 Q3,J,Information and communications,Information services,2122,1149,973,51,371
All,2003 Q3,K,Financing and insurance,Financial services (except insurance and pension funding),93726,42489,51237,958,5185
All,2003 Q3,K,Financing and insurance,Insurance,11348,4227,7121,132,131
All,2003 Q3,K,Financing and insurance,Services auxiliary to financial and insurance services,39382,19257,20125,670,9593
All,2003 Q3,L,Real estate,Real estate,85559,58074,27485,1535,8536
All,2003 Q3,M,"Professional, scientific and technical services",Legal and accounting services,34106,15272,18834,192,5225
All,2003 Q3,M,"Professional, scientific and technical services",Activities of head offices; management and management consultancy services,19205,8980,10225,251,3545
All,2003 Q3,M,"Professional, scientific and technical services","Architecture and engineering services, technical testing and analysis",27325,18669,8656,231,2351
All,2003 Q3,M,"Professional, scientific and technical services",Scientific research and development,573,368,205,8,43
All,2003 Q3,M,"Professional, scientific and technical services",Advertising and market research,13680,7242,6438,200,3300
All,2003 Q3,M,"Professional, scientific and technical services","Veterinary services; Other professional, scientific and technical services",14983,9203,5780,205,4573
All,2003 Q3,N,Administrative and support services,Rental and leasing services,1753,1233,520,13,494
All,2003 Q3,N,Administrative and support services,Employment services,5881,2159,3722,76,1446
All,2003 Q3,N,Administrative and support services,"Travel agency, reservation service and related services",15963,6531,9432,143,2004
All,2003 Q3,N,Administrative and support services,Security and investigation services,36863,30721,6142,524,215
All,2003 Q3,N,Administrative and support services,Services to buildings and landscape care,53010,17327,35683,188,1308
All,2003 Q3,N,Administrative and support services,"Office administrative, office support and other business support services",15128,7428,7700,284,3572
All,2003 Q3,P,Education,Education,129611,47945,81666,700,4766
All,2003 Q3,Q,Human health and social work services,Human health services,72556,20947,51609,1112,4868
All,2003 Q3,Q,Human health and social work services,Residential care services,27832,3541,24291,289,1151
All,2003 Q3,Q,Human health and social work services,Social work services,27100,6520,20580,751,1659
All,2003 Q3,R,"Arts, entertainment and recreation",Creative and performing arts activities,1834,1035,799,14,519
All,2003 Q3,R,"Arts, entertainment and recreation","Libraries, archives, museums and other cultural activities",344,133,211,2,81
All,2003 Q3,R,"Arts, entertainment and recreation",Amusement parks and theme parks,0,0,0,0,0
All,2003 Q3,R,"Arts, entertainment and recreation",Sports and other entertainment services,0,0,0,0,0
All,2003 Q3,S,Other services,Activities of membership organisations,9327,4061,5266,42,934
All,2003 Q3,S,Other services,"Repair of motor vehicles, motorcycles, computers, personal and household goods",16338,13461,2877,216,4816
All,2003 Q3,S,Other services,Other personal services,34688,13984,20704,573,8290
All,2003 Q4,C,Manufacturing,Manufacture of food products,19406,11406,8000,115,755
All,2003 Q4,C,Manufacturing,Manufacture of beverages,3171,2422,749,16,23
All,2003 Q4,C,Manufacturing,Manufacture of tobacco products,498,369,129,0,3
All,2003 Q4,C,Manufacturing,Manufacture of textiles,11202,6497,4705,18,1011
All,2003 Q4,C,Manufacturing,Manufacture of wearing apparel,31601,8291,23310,182,1614
All,2003 Q4,C,Manufacturing,"Manufacture of leather and related products; Manufacture of wood and of products of wood and cork, articles of straw and plaiting materials (except furniture and toys)",738,532,206,8,231
All,2003 Q4,C,Manufacturing,Manufacture of paper and paper products,2297,1571,726,13,455
All,2003 Q4,C,Manufacturing,Printing and reproduction of recorded media,23564,16571,6993,121,3364
All,2003 Q4,C,Manufacturing,Manufacture of coke and refined petroleum products; Manufacture of chemicals and chemical products,2218,1627,591,7,232
All,2003 Q4,C,Manufacturing,"Manufacture of pharmaceuticals, medicinal chemical and botanical products",2788,1348,1440,20,259
All,2003 Q4,C,Manufacturing,"Manufacture of rubber and plastics products (except furniture, toys, sports goods and stationery)",3532,2317,1215,22,485
All,2003 Q4,C,Manufacturing,Manufacture of other non-metallic mineral products,1580,1240,340,0,221
All,2003 Q4,C,Manufacturing,Manufacture of basic metals,1321,1093,228,8,113
All,2003 Q4,C,Manufacturing,Manufacture of fabricated metal products (except machinery and equipment),5186,3964,1222,0,1220
All,2003 Q4,C,Manufacturing,"Manufacture of computer, electronic and optical products",12420,6329,6091,115,424
All,2003 Q4,C,Manufacturing,Manufacture of electrical equipment,3485,1903,1582,6,281
All,2003 Q4,C,Manufacturing,Manufacture of machinery and equipment n.e.c.,3453,2918,535,1,853
All,2003 Q4,C,Manufacturing,Body assembly of motor vehicles; Manufacture of other transport equipment,2138,1779,359,0,126
All,2003 Q4,C,Manufacturing,Manufacture of furniture,400,335,65,0,158
All,2003 Q4,C,Manufacturing,Other manufacturing,8604,5493,3111,55,1734
All,2003 Q4,C,Manufacturing,Repair and installation of machinery and equipment,10953,9130,1823,74,1426
All,2003 Q4,B,Mining and quarrying,Quarrying and other mining of non-metal ores,180,175,5,0,7
All,2003 Q4,D,Electricity and gas supply,Electricity and gas supply,8337,7097,1240,6,16
All,2003 Q4,E,"Sewerage, waste management and remediation services",Sewerage,228,85,143,0,42
All,2003 Q4,E,"Sewerage, waste management and remediation services","Waste collection, treatment and disposal; materials recovery",2856,1332,1524,0,249
All,2003 Q4,E,"Sewerage, waste management and remediation services",Remediation and other waste management services,93,43,50,0,15
All,2003 Q4,F,Construction,Construction sites (manual workers only),68306,63499,4807,36,1044
All,2003 Q4,F,Construction,Public sector sites,32394,31009,1385,36,445
All,2003 Q4,F,Construction,Public sector building sites,15464,14698,766,0,184
All,2003 Q4,F,Construction,Public sector civil engineering sites,16930,16311,619,36,261
All,2003 Q4,F,Construction,Private sector sites,35912,32490,3422,0,599
All,2003 Q4,F,Construction,Private sector building sites,33745,30437,3308,0,503
All,2003 Q4,F,Construction,Private sector civil engineering sites,2167,2053,114,0,96
All,2003 Q4,G,"Import/export, wholesale and retail trades",Import and export trade,489851,258122,231729,4451,96744
All,2003 Q4,G,"Import/export, wholesale and retail trades",Wholesale,64207,40224,23983,377,14426
All,2003 Q4,G,"Import/export, wholesale and retail trades",Retail trade,213211,93238,119973,2326,54493
All,2003 Q4,H,"Transportation, storage, postal and courier services",Land transport,44108,38177,5931,188,2687
All,2003 Q4,H,"Transportation, storage, postal and courier services",Water transport,8875,5565,3310,78,338
All,2003 Q4,H,"Transportation, storage, postal and courier services",Air transport,16478,6495,9983,57,110
All,2003 Q4,H,"Transportation, storage, postal and courier services",Warehousing and support services for transportation,56491,35292,21199,300,4205
All,2003 Q4,H,"Transportation, storage, postal and courier services",Postal and courier services,11688,7973,3715,63,650
All,2003 Q4,I,Accommodation and food services,Accommodation services,24201,13943,10258,272,696
All,2003 Q4,I,Accommodation and food services,Food and beverage services,180347,84735,95612,1417,11304
All,2003 Q4,J,Information and communications,Publishing,18909,10917,7992,127,1402
All,2003 Q4,J,Information and communications,"Motion picture, video and television programme production, sound recording and music publishing; Programming and broadcasting",15142,9830,5312,77,1598
All,2003 Q4,J,Information and communications,Telecommunications,18085,10676,7409,142,388
All,2003 Q4,J,Information and communications,Information technology services,27250,20449,6801,737,4299
All,2003 Q4,J,Information and communications,Information services,3134,1813,1321,67,400
All,2003 Q4,K,Financing and insurance,Financial services (except insurance and pension funding),95942,42635,53307,1028,5069
All,2003 Q4,K,Financing and insurance,Insurance,11644,4345,7299,159,136
All,2003 Q4,K,Financing and insurance,Services auxiliary to financial and insurance services,40015,19347,20668,1038,9473
All,2003 Q4,L,Real estate,Real estate,86728,59311,27417,1363,8708
All,2003 Q4,M,"Professional, scientific and technical services",Legal and accounting services,33424,14843,18581,170,5148
All,2003 Q4,M,"Professional, scientific and technical services",Activities of head offices; management and management consultancy services,18407,8714,9693,279,3361
All,2003 Q4,M,"Professional, scientific and technical services","Architecture and engineering services, technical testing and analysis",25791,17251,8540,233,2471
All,2003 Q4,M,"Professional, scientific and technical services",Scientific research and development,482,315,167,25,33
All,2003 Q4,M,"Professional, scientific and technical services",Advertising and market research,12945,7209,5736,198,3229
All,2003 Q4,M,"Professional, scientific and technical services","Veterinary services; Other professional, scientific and technical services",16119,9465,6654,225,4531
All,2003 Q4,N,Administrative and support services,Rental and leasing services,1907,1256,651,2,543
All,2003 Q4,N,Administrative and support services,Employment services,6785,2663,4122,185,1293
All,2003 Q4,N,Administrative and support services,"Travel agency, reservation service and related services",17143,7402,9741,70,2102
All,2003 Q4,N,Administrative and support services,Security and investigation services,34927,28757,6170,444,254
All,2003 Q4,N,Administrative and support services,Services to buildings and landscape care,54872,19004,35868,184,1312
All,2003 Q4,N,Administrative and support services,"Office administrative, office support and other business support services",15626,7963,7663,246,3683
All,2003 Q4,P,Education,Education,131131,48241,82890,515,4919
All,2003 Q4,Q,Human health and social work services,Human health services,72276,20863,51413,925,4797
All,2003 Q4,Q,Human health and social work services,Residential care services,27410,3578,23832,317,1176
All,2003 Q4,Q,Human health and social work services,Social work services,27171,6563,20608,578,1582
All,2003 Q4,R,"Arts, entertainment and recreation",Creative and performing arts activities,1796,1062,734,1,402
All,2003 Q4,R,"Arts, entertainment and recreation","Libraries, archives, museums and other cultural activities",391,150,241,1,79
All,2003 Q4,R,"Arts, entertainment and recreation",Amusement parks and theme parks,0,0,0,0,0
All,2003 Q4,R,"Arts, entertainment and recreation",Sports and other entertainment services,0,0,0,0,0
All,2003 Q4,S,Other services,Activities of membership organisations,9114,3759,5355,112,964
All,2003 Q4,S,Other services,"Repair of motor vehicles, motorcycles, computers, personal and household goods",16721,13482,3239,25,4885
All,2003 Q4,S,Other services,Other personal services,33183,12332,20851,408,8004
All,2004 Q1,C,Manufacturing,Manufacture of food products,19893,11514,8379,164,739
All,2004 Q1,C,Manufacturing,Manufacture of beverages,3107,2387,720,36,23
All,2004 Q1,C,Manufacturing,Manufacture of tobacco products,523,389,134,2,3
All,2004 Q1,C,Manufacturing,Manufacture of textiles,11195,6505,4690,46,1010
All,2004 Q1,C,Manufacturing,Manufacture of wearing apparel,31460,8257,23203,340,1821
All,2004 Q1,C,Manufacturing,"Manufacture of leather and related products; Manufacture of wood and of products of wood and cork, articles of straw and plaiting materials (except furniture and toys)",707,511,196,8,228
All,2004 Q1,C,Manufacturing,Manufacture of paper and paper products,2251,1648,603,19,444
All,2004 Q1,C,Manufacturing,Printing and reproduction of recorded media,23988,16394,7594,142,3373
All,2004 Q1,C,Manufacturing,Manufacture of coke and refined petroleum products; Manufacture of chemicals and chemical products,2358,1530,828,30,236
All,2004 Q1,C,Manufacturing,"Manufacture of pharmaceuticals, medicinal chemical and botanical products",2522,1110,1412,12,257
All,2004 Q1,C,Manufacturing,"Manufacture of rubber and plastics products (except furniture, toys, sports goods and stationery)",3338,2204,1134,6,581
All,2004 Q1,C,Manufacturing,Manufacture of other non-metallic mineral products,1266,1002,264,36,218
All,2004 Q1,C,Manufacturing,Manufacture of basic metals,1281,1077,204,13,74
All,2004 Q1,C,Manufacturing,Manufacture of fabricated metal products (except machinery and equipment),6628,4898,1730,12,1322
All,2004 Q1,C,Manufacturing,"Manufacture of computer, electronic and optical products",12269,6304,5965,141,367
All,2004 Q1,C,Manufacturing,Manufacture of electrical equipment,3316,1783,1533,15,293
All,2004 Q1,C,Manufacturing,Manufacture of machinery and equipment n.e.c.,2994,2545,449,39,813
All,2004 Q1,C,Manufacturing,Body assembly of motor vehicles; Manufacture of other transport equipment,1967,1550,417,3,120
All,2004 Q1,C,Manufacturing,Manufacture of furniture,373,304,69,40,157
All,2004 Q1,C,Manufacturing,Other manufacturing,9161,5973,3188,95,1662
All,2004 Q1,C,Manufacturing,Repair and installation of machinery and equipment,11052,9204,1848,98,1501
All,2004 Q1,B,Mining and quarrying,Quarrying and other mining of non-metal ores,172,163,9,0,6
All,2004 Q1,D,Electricity and gas supply,Electricity and gas supply,8235,7042,1193,2,15
All,2004 Q1,E,"Sewerage, waste management and remediation services",Sewerage,417,233,184,4,39
All,2004 Q1,E,"Sewerage, waste management and remediation services","Waste collection, treatment and disposal; materials recovery",2169,1196,973,4,212
All,2004 Q1,E,"Sewerage, waste management and remediation services",Remediation and other waste management services,100,45,55,0,15
All,2004 Q1,F,Construction,Construction sites (manual workers only),69077,64109,4968,41,1043
All,2004 Q1,F,Construction,Public sector sites,32328,30935,1393,41,447
All,2004 Q1,F,Construction,Public sector building sites,16039,15246,793,0,190
All,2004 Q1,F,Construction,Public sector civil engineering sites,16289,15689,600,41,257
All,2004 Q1,F,Construction,Private sector sites,36749,33174,3575,0,596
All,2004 Q1,F,Construction,Private sector building sites,34684,31226,3458,0,503
All,2004 Q1,F,Construction,Private sector civil engineering sites,2065,1948,117,0,93
All,2004 Q1,G,"Import/export, wholesale and retail trades",Import and export trade,485397,258737,226660,6330,94988
All,2004 Q1,G,"Import/export, wholesale and retail trades",Wholesale,68887,43140,25747,802,15445
All,2004 Q1,G,"Import/export, wholesale and retail trades",Retail trade,211483,93194,118289,2211,54353
All,2004 Q1,H,"Transportation, storage, postal and courier services",Land transport,44198,38499,5699,372,2805
All,2004 Q1,H,"Transportation, storage, postal and courier services",Water transport,8560,5425,3135,49,301
All,2004 Q1,H,"Transportation, storage, postal and courier services",Air transport,16730,6467,10263,65,110
All,2004 Q1,H,"Transportation, storage, postal and courier services",Warehousing and support services for transportation,58592,36592,22000,508,4231
All,2004 Q1,H,"Transportation, storage, postal and courier services",Postal and courier services,10610,7112,3498,171,620
All,2004 Q1,I,Accommodation and food services,Accommodation services,24639,13977,10662,310,661
All,2004 Q1,I,Accommodation and food services,Food and beverage services,182182,84609,97573,1470,11499
All,2004 Q1,J,Information and communications,Publishing,18884,11439,7445,214,1516
All,2004 Q1,J,Information and communications,"Motion picture, video and television programme production, sound recording and music publishing; Programming and broadcasting",15416,9802,5614,157,1632
All,2004 Q1,J,Information and communications,Telecommunications,18413,10997,7416,222,381
All,2004 Q1,J,Information and communications,Information technology services,28901,21529,7372,589,4438
All,2004 Q1,J,Information and communications,Information services,2403,1306,1097,45,437
All,2004 Q1,K,Financing and insurance,Financial services (except insurance and pension funding),95639,43887,51752,1328,5211
All,2004 Q1,K,Financing and insurance,Insurance,11395,4193,7202,168,131
All,2004 Q1,K,Financing and insurance,Services auxiliary to financial and insurance services,39998,19518,20480,1403,9636
All,2004 Q1,L,Real estate,Real estate,85568,57748,27820,2256,8916
All,2004 Q1,M,"Professional, scientific and technical services",Legal and accounting services,33754,15201,18553,306,5204
All,2004 Q1,M,"Professional, scientific and technical services",Activities of head offices; management and management consultancy services,22892,11560,11332,457,3967
All,2004 Q1,M,"Professional, scientific and technical services","Architecture and engineering services, technical testing and analysis",25877,17848,8029,343,2527
All,2004 Q1,M,"Professional, scientific and technical services",Scientific research and development,603,387,216,28,41
All,2004 Q1,M,"Professional, scientific and technical services",Advertising and market research,12055,6655,5400,250,3072
All,2004 Q1,M,"Professional, scientific and technical services","Veterinary services; Other professional, scientific and technical services",14958,8848,6110,282,4696
All,2004 Q1,N,Administrative and support services,Rental and leasing services,1811,1078,733,22,563
All,2004 Q1,N,Administrative and support services,Employment services,7781,3061,4720,239,1407
All,2004 Q1,N,Administrative and support services,"Travel agency, reservation service and related services",17284,7239,10045,248,2077
All,2004 Q1,N,Administrative and support services,Security and investigation services,33823,27986,5837,432,124
All,2004 Q1,N,Administrative and support services,Services to buildings and landscape care,53183,19160,34023,325,1284
All,2004 Q1,N,Administrative and support services,"Office administrative, office support and other business support services",18577,9601,8976,765,3929
All,2004 Q1,P,Education,Education,130933,48750,82183,901,5108
All,2004 Q1,Q,Human health and social work services,Human health services,73884,21266,52618,834,4818
All,2004 Q1,Q,Human health and social work services,Residential care services,25101,3335,21766,417,1111
All,2004 Q1,Q,Human health and social work services,Social work services,25195,6060,19135,353,1673
All,2004 Q1,R,"Arts, entertainment and recreation",Creative and performing arts activities,1990,1154,836,16,599
All,2004 Q1,R,"Arts, entertainment and recreation","Libraries, archives, museums and other cultural activities",467,182,285,6,87
All,2004 Q1,R,"Arts, entertainment and recreation",Amusement parks and theme parks,0,0,0,0,0
All,2004 Q1,R,"Arts, entertainment and recreation",Sports and other entertainment services,0,0,0,0,0
All,2004 Q1,S,Other services,Activities of membership organisations,8852,3917,4935,115,911
All,2004 Q1,S,Other services,"Repair of motor vehicles, motorcycles, computers, personal and household goods",16773,13703,3070,121,5012
All,2004 Q1,S,Other services,Other personal services,34061,13106,20955,872,8284
All,2004 Q2,C,Manufacturing,Manufacture of food products,18737,11175,7562,100,693
All,2004 Q2,C,Manufacturing,Manufacture of beverages,3145,2429,716,17,24
All,2004 Q2,C,Manufacturing,Manufacture of tobacco products,523,390,133,13,3
All,2004 Q2,C,Manufacturing,Manufacture of textiles,11086,6498,4588,69,1007
All,2004 Q2,C,Manufacturing,Manufacture of wearing apparel,31059,8073,22986,431,1665
All,2004 Q2,C,Manufacturing,"Manufacture of leather and related products; Manufacture of wood and of products of wood and cork, articles of straw and plaiting materials (except furniture and toys)",736,514,222,11,213
All,2004 Q2,C,Manufacturing,Manufacture of paper and paper products,2365,1713,652,11,464
All,2004 Q2,C,Manufacturing,Printing and reproduction of recorded media,24646,16559,8087,198,3381
All,2004 Q2,C,Manufacturing,Manufacture of coke and refined petroleum products; Manufacture of chemicals and chemical products,2415,1663,752,28,222
All,2004 Q2,C,Manufacturing,"Manufacture of pharmaceuticals, medicinal chemical and botanical products",3460,1511,1949,27,236
All,2004 Q2,C,Manufacturing,"Manufacture of rubber and plastics products (except furniture, toys, sports goods and stationery)",3372,2250,1122,12,618
All,2004 Q2,C,Manufacturing,Manufacture of other non-metallic mineral products,1217,1022,195,0,195
All,2004 Q2,C,Manufacturing,Manufacture of basic metals,1136,927,209,12,81
All,2004 Q2,C,Manufacturing,Manufacture of fabricated metal products (except machinery and equipment),5528,4122,1406,43,1295
All,2004 Q2,C,Manufacturing,"Manufacture of computer, electronic and optical products",12464,6401,6063,140,357
All,2004 Q2,C,Manufacturing,Manufacture of electrical equipment,3220,1772,1448,21,278
All,2004 Q2,C,Manufacturing,Manufacture of machinery and equipment n.e.c.,3430,2877,553,0,847
All,2004 Q2,C,Manufacturing,Body assembly of motor vehicles; Manufacture of other transport equipment,1942,1512,430,18,135
All,2004 Q2,C,Manufacturing,Manufacture of furniture,505,404,101,17,157
All,2004 Q2,C,Manufacturing,Other manufacturing,10014,6441,3573,171,1722
All,2004 Q2,C,Manufacturing,Repair and installation of machinery and equipment,10473,8798,1675,74,1375
All,2004 Q2,B,Mining and quarrying,Quarrying and other mining of non-metal ores,155,150,5,0,6
All,2004 Q2,D,Electricity and gas supply,Electricity and gas supply,8283,7077,1206,3,15
All,2004 Q2,E,"Sewerage, waste management and remediation services",Sewerage,232,128,104,0,37
All,2004 Q2,E,"Sewerage, waste management and remediation services","Waste collection, treatment and disposal; materials recovery",2014,966,1048,9,223
All,2004 Q2,E,"Sewerage, waste management and remediation services",Remediation and other waste management services,46,25,21,0,15
All,2004 Q2,F,Construction,Construction sites (manual workers only),69892,64624,5268,59,1051
All,2004 Q2,F,Construction,Public sector sites,31151,29669,1482,58,426
All,2004 Q2,F,Construction,Public sector building sites,14331,13478,853,0,182
All,2004 Q2,F,Construction,Public sector civil engineering sites,16820,16191,629,58,244
All,2004 Q2,F,Construction,Private sector sites,38741,34955,3786,1,625
All,2004 Q2,F,Construction,Private sector building sites,36077,32436,3641,1,529
All,2004 Q2,F,Construction,Private sector civil engineering sites,2664,2519,145,0,96
All,2004 Q2,G,"Import/export, wholesale and retail trades",Import and export trade,493704,259242,234462,7903,94503
All,2004 Q2,G,"Import/export, wholesale and retail trades",Wholesale,67925,42699,25226,795,15243
All,2004 Q2,G,"Import/export, wholesale and retail trades",Retail trade,212911,91970,120941,2339,54729
All,2004 Q2,H,"Transportation, storage, postal and courier services",Land transport,42878,37346,5532,292,2567
All,2004 Q2,H,"Transportation, storage, postal and courier services",Water transport,8943,5541,3402,102,303
All,2004 Q2,H,"Transportation, storage, postal and courier services",Air transport,16798,6478,10320,101,109
All,2004 Q2,H,"Transportation, storage, postal and courier services",Warehousing and support services for transportation,61344,38099,23245,685,4146
All,2004 Q2,H,"Transportation, storage, postal and courier services",Postal and courier services,11284,7333,3951,157,659
All,2004 Q2,I,Accommodation and food services,Accommodation services,25100,14200,10900,430,685
All,2004 Q2,I,Accommodation and food services,Food and beverage services,187391,88926,98465,1830,11647
All,2004 Q2,J,Information and communications,Publishing,19181,11175,8006,221,1525
All,2004 Q2,J,Information and communications,"Motion picture, video and television programme production, sound recording and music publishing; Programming and broadcasting",14627,9233,5394,106,1449
All,2004 Q2,J,Information and communications,Telecommunications,18066,10838,7228,182,363
All,2004 Q2,J,Information and communications,Information technology services,28108,21145,6963,670,4093
All,2004 Q2,J,Information and communications,Information services,2549,1326,1223,78,436
All,2004 Q2,K,Financing and insurance,Financial services (except insurance and pension funding),96363,44126,52237,1468,5173
All,2004 Q2,K,Financing and insurance,Insurance,11567,4329,7238,131,129
All,2004 Q2,K,Financing and insurance,Services auxiliary to financial and insurance services,38548,18242,20306,2003,9224
All,2004 Q2,L,Real estate,Real estate,88393,61210,27183,1649,8951
All,2004 Q2,M,"Professional, scientific and technical services",Legal and accounting services,34334,15449,18885,248,5162
All,2004 Q2,M,"Professional, scientific and technical services",Activities of head offices; management and management consultancy services,22238,10802,11436,570,3985
All,2004 Q2,M,"Professional, scientific and technical services","Architecture and engineering services, technical testing and analysis",25375,17660,7715,337,2384
All,2004 Q2,M,"Professional, scientific and technical services",Scientific research and development,625,361,264,19,41
All,2004 Q2,M,"Professional, scientific and technical services",Advertising and market research,11968,6854,5114,205,3028
All,2004 Q2,M,"Professional, scientific and technical services","Veterinary services; Other professional, scientific and technical services",17079,9678,7401,365,4669
All,2004 Q2,N,Administrative and support services,Rental and leasing services,1777,1105,672,12,492
All,2004 Q2,N,Administrative and support services,Employment services,8097,3095,5002,183,1369
All,2004 Q2,N,Administrative and support services,"Travel agency, reservation service and related services",18009,7482,10527,399,2007
All,2004 Q2,N,Administrative and support services,Security and investigation services,35004,28540,6464,528,154
All,2004 Q2,N,Administrative and support services,Services to buildings and landscape care,54167,18441,35726,393,1254
All,2004 Q2,N,Administrative and support services,"Office administrative, office support and other business support services",19574,9615,9959,705,3959
All,2004 Q2,P,Education,Education,131477,48965,82512,1044,5114
All,2004 Q2,Q,Human health and social work services,Human health services,74394,20945,53449,916,4844
All,2004 Q2,Q,Human health and social work services,Residential care services,24528,3528,21000,483,1033
All,2004 Q2,Q,Human health and social work services,Social work services,28140,6753,21387,426,1733
All,2004 Q2,R,"Arts, entertainment and recreation",Creative and performing arts activities,2060,1193,867,59,549
All,2004 Q2,R,"Arts, entertainment and recreation","Libraries, archives, museums and other cultural activities",405,159,246,5,77
All,2004 Q2,R,"Arts, entertainment and recreation",Amusement parks and theme parks,0,0,0,0,0
All,2004 Q2,R,"Arts, entertainment and recreation",Sports and other entertainment services,0,0,0,0,0
All,2004 Q2,S,Other services,Activities of membership organisations,8901,3978,4923,240,888
All,2004 Q2,S,Other services,"Repair of motor vehicles, motorcycles, computers, personal and household goods",18277,14889,3388,195,5109
All,2004 Q2,S,Other services,Other personal services,34897,12843,22054,1192,8076
All,2004 Q3,C,Manufacturing,Manufacture of food products,20181,11619,8562,156,726
All,2004 Q3,C,Manufacturing,Manufacture of beverages,3160,2353,807,16,22
All,2004 Q3,C,Manufacturing,Manufacture of tobacco products,528,387,141,2,3
All,2004 Q3,C,Manufacturing,Manufacture of textiles,10666,6205,4461,29,987
All,2004 Q3,C,Manufacturing,Manufacture of wearing apparel,32026,7917,24109,355,1756
All,2004 Q3,C,Manufacturing,"Manufacture of leather and related products; Manufacture of wood and of products of wood and cork, articles of straw and plaiting materials (except furniture and toys)",745,536,209,2,215
All,2004 Q3,C,Manufacturing,Manufacture of paper and paper products,2292,1612,680,28,466
All,2004 Q3,C,Manufacturing,Printing and reproduction of recorded media,22927,15480,7447,274,3317
All,2004 Q3,C,Manufacturing,Manufacture of coke and refined petroleum products; Manufacture of chemicals and chemical products,2514,1761,753,19,217
All,2004 Q3,C,Manufacturing,"Manufacture of pharmaceuticals, medicinal chemical and botanical products",2830,1323,1507,11,229
All,2004 Q3,C,Manufacturing,"Manufacture of rubber and plastics products (except furniture, toys, sports goods and stationery)",2996,2035,961,2,592
All,2004 Q3,C,Manufacturing,Manufacture of other non-metallic mineral products,1258,1054,204,1,197
All,2004 Q3,C,Manufacturing,Manufacture of basic metals,1256,1053,203,8,78
All,2004 Q3,C,Manufacturing,Manufacture of fabricated metal products (except machinery and equipment),5638,4171,1467,20,1324
All,2004 Q3,C,Manufacturing,"Manufacture of computer, electronic and optical products",12741,6671,6070,109,401
All,2004 Q3,C,Manufacturing,Manufacture of electrical equipment,3319,1758,1561,21,286
All,2004 Q3,C,Manufacturing,Manufacture of machinery and equipment n.e.c.,2995,2570,425,6,767
All,2004 Q3,C,Manufacturing,Body assembly of motor vehicles; Manufacture of other transport equipment,1937,1518,419,11,108
All,2004 Q3,C,Manufacturing,Manufacture of furniture,395,336,59,1,146
All,2004 Q3,C,Manufacturing,Other manufacturing,9303,5813,3490,106,1671
All,2004 Q3,C,Manufacturing,Repair and installation of machinery and equipment,10479,8706,1773,179,1384
All,2004 Q3,B,Mining and quarrying,Quarrying and other mining of non-metal ores,145,139,6,1,6
All,2004 Q3,D,Electricity and gas supply,Electricity and gas supply,8209,7026,1183,1,15
All,2004 Q3,E,"Sewerage, waste management and remediation services",Sewerage,286,190,96,0,35
All,2004 Q3,E,"Sewerage, waste management and remediation services","Waste collection, treatment and disposal; materials recovery",2000,1077,923,9,189
All,2004 Q3,E,"Sewerage, waste management and remediation services",Remediation and other waste management services,21,12,9,0,14
All,2004 Q3,F,Construction,Construction sites (manual workers only),64903,59850,5053,44,1012
All,2004 Q3,F,Construction,Public sector sites,29089,27682,1407,32,400
All,2004 Q3,F,Construction,Public sector building sites,12109,11424,685,11,161
All,2004 Q3,F,Construction,Public sector civil engineering sites,16980,16258,722,21,239
All,2004 Q3,F,Construction,Private sector sites,35814,32168,3646,12,612
All,2004 Q3,F,Construction,Private sector building sites,33142,29632,3510,12,505
All,2004 Q3,F,Construction,Private sector civil engineering sites,2672,2536,136,0,107
All,2004 Q3,G,"Import/export, wholesale and retail trades",Import and export trade,509232,265840,243392,7005,95349
All,2004 Q3,G,"Import/export, wholesale and retail trades",Wholesale,66326,41165,25161,973,14724
All,2004 Q3,G,"Import/export, wholesale and retail trades",Retail trade,216193,93793,122400,3247,53276
All,2004 Q3,H,"Transportation, storage, postal and courier services",Land transport,42917,37452,5465,331,2784
All,2004 Q3,H,"Transportation, storage, postal and courier services",Water transport,8622,5381,3241,84,272
All,2004 Q3,H,"Transportation, storage, postal and courier services",Air transport,16966,6602,10364,100,110
All,2004 Q3,H,"Transportation, storage, postal and courier services",Warehousing and support services for transportation,60833,37549,23284,793,4083
All,2004 Q3,H,"Transportation, storage, postal and courier services",Postal and courier services,10167,6936,3231,181,604
All,2004 Q3,I,Accommodation and food services,Accommodation services,25347,14679,10668,490,703
All,2004 Q3,I,Accommodation and food services,Food and beverage services,183920,86966,96954,2038,11573
All,2004 Q3,J,Information and communications,Publishing,18487,10614,7873,282,1384
All,2004 Q3,J,Information and communications,"Motion picture, video and television programme production, sound recording and music publishing; Programming and broadcasting",15267,9742,5525,134,1630
All,2004 Q3,J,Information and communications,Telecommunications,17780,10717,7063,454,337
All,2004 Q3,J,Information and communications,Information technology services,27946,21083,6863,385,4431
All,2004 Q3,J,Information and communications,Information services,2838,1421,1417,95,363
All,2004 Q3,K,Financing and insurance,Financial services (except insurance and pension funding),95699,43756,51943,1387,4977
All,2004 Q3,K,Financing and insurance,Insurance,12105,5005,7100,210,126
All,2004 Q3,K,Financing and insurance,Services auxiliary to financial and insurance services,39218,18686,20532,1559,9397
All,2004 Q3,L,Real estate,Real estate,89211,61610,27601,1969,8870
All,2004 Q3,M,"Professional, scientific and technical services",Legal and accounting services,34181,15159,19022,206,5072
All,2004 Q3,M,"Professional, scientific and technical services",Activities of head offices; management and management consultancy services,23728,12141,11587,1320,3928
All,2004 Q3,M,"Professional, scientific and technical services","Architecture and engineering services, technical testing and analysis",26346,18305,8041,281,2310
All,2004 Q3,M,"Professional, scientific and technical services",Scientific research and development,537,352,185,17,36
All,2004 Q3,M,"Professional, scientific and technical services",Advertising and market research,12348,6525,5823,210,2989
All,2004 Q3,M,"Professional, scientific and technical services","Veterinary services; Other professional, scientific and technical services",17211,9566,7645,407,4704
All,2004 Q3,N,Administrative and support services,Rental and leasing services,1924,1069,855,14,394
All,2004 Q3,N,Administrative and support services,Employment services,9827,4502,5325,205,1357
All,2004 Q3,N,Administrative and support services,"Travel agency, reservation service and related services",19232,7608,11624,354,2159
All,2004 Q3,N,Administrative and support services,Security and investigation services,35514,28566,6948,826,129
All,2004 Q3,N,Administrative and support services,Services to buildings and landscape care,53805,18794,35011,297,1267
All,2004 Q3,N,Administrative and support services,"Office administrative, office support and other business support services",17267,8677,8590,369,3742
All,2004 Q3,P,Education,Education,129143,47570,81573,1091,5157
All,2004 Q3,Q,Human health and social work services,Human health services,73918,20723,53195,900,4829
All,2004 Q3,Q,Human health and social work services,Residential care services,23865,3569,20296,368,964
All,2004 Q3,Q,Human health and social work services,Social work services,30429,7379,23050,451,1802
All,2004 Q3,R,"Arts, entertainment and recreation",Creative and performing arts activities,2158,1263,895,37,585
All,2004 Q3,R,"Arts, entertainment and recreation","Libraries, archives, museums and other cultural activities",399,150,249,13,73
All,2004 Q3,R,"Arts, entertainment and recreation",Amusement parks and theme parks,0,0,0,0,0
All,2004 Q3,R,"Arts, entertainment and recreation",Sports and other entertainment services,0,0,0,0,0
All,2004 Q3,S,Other services,Activities of membership organisations,9185,3973,5212,95,871
All,2004 Q3,S,Other services,"Repair of motor vehicles, motorcycles, computers, personal and household goods",16974,13861,3113,128,4924
All,2004 Q3,S,Other services,Other personal services,34865,13020,21845,934,8321
All,2004 Q4,C,Manufacturing,Manufacture of food products,19434,11199,8235,137,728
All,2004 Q4,C,Manufacturing,Manufacture of beverages,3282,2484,798,8,24
All,2004 Q4,C,Manufacturing,Manufacture of tobacco products,529,389,140,2,3
All,2004 Q4,C,Manufacturing,Manufacture of textiles,10816,6233,4583,60,937
All,2004 Q4,C,Manufacturing,Manufacture of wearing apparel,31663,7978,23685,295,1781
All,2004 Q4,C,Manufacturing,"Manufacture of leather and related products; Manufacture of wood and of products of wood and cork, articles of straw and plaiting materials (except furniture and toys)",616,461,155,14,191
All,2004 Q4,C,Manufacturing,Manufacture of paper and paper products,2138,1478,660,4,426
All,2004 Q4,C,Manufacturing,Printing and reproduction of recorded media,22134,14708,7426,210,3248
All,2004 Q4,C,Manufacturing,Manufacture of coke and refined petroleum products; Manufacture of chemicals and chemical products,2662,1832,830,26,221
All,2004 Q4,C,Manufacturing,"Manufacture of pharmaceuticals, medicinal chemical and botanical products",2662,1217,1445,27,230
All,2004 Q4,C,Manufacturing,"Manufacture of rubber and plastics products (except furniture, toys, sports goods and stationery)",3079,1989,1090,2,585
All,2004 Q4,C,Manufacturing,Manufacture of other non-metallic mineral products,1231,1020,211,0,202
All,2004 Q4,C,Manufacturing,Manufacture of basic metals,1127,933,194,10,75
All,2004 Q4,C,Manufacturing,Manufacture of fabricated metal products (except machinery and equipment),4552,3525,1027,33,1125
All,2004 Q4,C,Manufacturing,"Manufacture of computer, electronic and optical products",13262,6603,6659,184,387
All,2004 Q4,C,Manufacturing,Manufacture of electrical equipment,2997,1689,1308,21,275
All,2004 Q4,C,Manufacturing,Manufacture of machinery and equipment n.e.c.,3269,2772,497,29,837
All,2004 Q4,C,Manufacturing,Body assembly of motor vehicles; Manufacture of other transport equipment,1872,1427,445,10,104
All,2004 Q4,C,Manufacturing,Manufacture of furniture,328,284,44,0,139
All,2004 Q4,C,Manufacturing,Other manufacturing,9508,5803,3705,62,1540
All,2004 Q4,C,Manufacturing,Repair and installation of machinery and equipment,10129,8436,1693,163,1219
All,2004 Q4,B,Mining and quarrying,Quarrying and other mining of non-metal ores,134,128,6,0,6
All,2004 Q4,D,Electricity and gas supply,Electricity and gas supply,8128,6956,1172,0,16
All,2004 Q4,E,"Sewerage, waste management and remediation services",Sewerage,347,217,130,0,34
All,2004 Q4,E,"Sewerage, waste management and remediation services","Waste collection, treatment and disposal; materials recovery",1917,1252,665,3,226
All,2004 Q4,E,"Sewerage, waste management and remediation services",Remediation and other waste management services,59,19,40,0,10
All,2004 Q4,F,Construction,Construction sites (manual workers only),61247,56354,4893,33,1010
All,2004 Q4,F,Construction,Public sector sites,27821,26576,1245,33,367
All,2004 Q4,F,Construction,Public sector building sites,10822,10206,616,7,140
All,2004 Q4,F,Construction,Public sector civil engineering sites,16999,16370,629,26,227
All,2004 Q4,F,Construction,Private sector sites,33426,29778,3648,0,643
All,2004 Q4,F,Construction,Private sector building sites,30571,27070,3501,0,529
All,2004 Q4,F,Construction,Private sector civil engineering sites,2855,2708,147,0,114
All,2004 Q4,G,"Import/export, wholesale and retail trades",Import and export trade,502270,262351,239919,5627,96379
All,2004 Q4,G,"Import/export, wholesale and retail trades",Wholesale,70094,43191,26903,800,14824
All,2004 Q4,G,"Import/export, wholesale and retail trades",Retail trade,215432,91371,124061,2588,53930
All,2004 Q4,H,"Transportation, storage, postal and courier services",Land transport,43830,38040,5790,315,2677
All,2004 Q4,H,"Transportation, storage, postal and courier services",Water transport,8775,5456,3319,32,275
All,2004 Q4,H,"Transportation, storage, postal and courier services",Air transport,17382,6835,10547,94,111
All,2004 Q4,H,"Transportation, storage, postal and courier services",Warehousing and support services for transportation,61576,37761,23815,443,4044
All,2004 Q4,H,"Transportation, storage, postal and courier services",Postal and courier services,11085,7365,3720,106,605
All,2004 Q4,I,Accommodation and food services,Accommodation services,25471,14214,11257,403,690
All,2004 Q4,I,Accommodation and food services,Food and beverage services,187572,86571,101001,1762,11576
All,2004 Q4,J,Information and communications,Publishing,18891,10979,7912,81,1510
All,2004 Q4,J,Information and communications,"Motion picture, video and television programme production, sound recording and music publishing; Programming and broadcasting",15439,9636,5803,130,1596
All,2004 Q4,J,Information and communications,Telecommunications,17857,10609,7248,260,336
All,2004 Q4,J,Information and communications,Information technology services,27949,20927,7022,480,4457
All,2004 Q4,J,Information and communications,Information services,3231,1484,1747,112,375
All,2004 Q4,K,Financing and insurance,Financial services (except insurance and pension funding),97307,44096,53211,1381,5075
All,2004 Q4,K,Financing and insurance,Insurance,12213,5098,7115,225,129
All,2004 Q4,K,Financing and insurance,Services auxiliary to financial and insurance services,41760,20122,21638,1257,9326
All,2004 Q4,L,Real estate,Real estate,87828,59872,27956,2059,8949
All,2004 Q4,M,"Professional, scientific and technical services",Legal and accounting services,36591,16028,20563,503,5085
All,2004 Q4,M,"Professional, scientific and technical services",Activities of head offices; management and management consultancy services,25063,12802,12261,804,3993
All,2004 Q4,M,"Professional, scientific and technical services","Architecture and engineering services, technical testing and analysis",26639,18533,8106,313,2499
All,2004 Q4,M,"Professional, scientific and technical services",Scientific research and development,595,372,223,32,34
All,2004 Q4,M,"Professional, scientific and technical services",Advertising and market research,11786,6567,5219,175,3043
All,2004 Q4,M,"Professional, scientific and technical services","Veterinary services; Other professional, scientific and technical services",15876,9456,6420,309,4594
All,2004 Q4,N,Administrative and support services,Rental and leasing services,1537,1104,433,9,432
All,2004 Q4,N,Administrative and support services,Employment services,10522,3861,6661,219,1413
All,2004 Q4,N,Administrative and support services,"Travel agency, reservation service and related services",19487,8127,11360,273,2141
All,2004 Q4,N,Administrative and support services,Security and investigation services,36602,29220,7382,781,129
All,2004 Q4,N,Administrative and support services,Services to buildings and landscape care,55418,22434,32984,447,1193
All,2004 Q4,N,Administrative and support services,"Office administrative, office support and other business support services",19382,9640,9742,320,3976
All,2004 Q4,P,Education,Education,134461,49456,85005,1112,5442
All,2004 Q4,Q,Human health and social work services,Human health services,74684,21001,53683,1023,4995
All,2004 Q4,Q,Human health and social work services,Residential care services,24240,3632,20608,408,1067
All,2004 Q4,Q,Human health and social work services,Social work services,29714,7315,22399,421,1802
All,2004 Q4,R,"Arts, entertainment and recreation",Creative and performing arts activities,2153,1238,915,6,527
All,2004 Q4,R,"Arts, entertainment and recreation","Libraries, archives, museums and other cultural activities",453,166,287,18,79
All,2004 Q4,R,"Arts, entertainment and recreation",Amusement parks and theme parks,0,0,0,0,0
All,2004 Q4,R,"Arts, entertainment and recreation",Sports and other entertainment services,0,0,0,0,0
All,2004 Q4,S,Other services,Activities of membership organisations,9828,4650,5178,153,876
All,2004 Q4,S,Other services,"Repair of motor vehicles, motorcycles, computers, personal and household goods",16354,13444,2910,150,4939
All,2004 Q4,S,Other services,Other personal services,34382,13541,20841,722,8420
All,2005 Q1,C,Manufacturing,Manufacture of food products,20307,11767,8540,168,730
All,2005 Q1,C,Manufacturing,Manufacture of beverages,3369,2576,793,28,22
All,2005 Q1,C,Manufacturing,Manufacture of tobacco products,523,386,137,3,3
All,2005 Q1,C,Manufacturing,Manufacture of textiles,10905,6254,4651,75,967
All,2005 Q1,C,Manufacturing,Manufacture of wearing apparel,30027,8040,21987,392,1703
All,2005 Q1,C,Manufacturing,"Manufacture of leather and related products; Manufacture of wood and of products of wood and cork, articles of straw and plaiting materials (except furniture and toys)",548,444,104,4,177
All,2005 Q1,C,Manufacturing,Manufacture of paper and paper products,1952,1437,515,9,415
All,2005 Q1,C,Manufacturing,Printing and reproduction of recorded media,21394,14732,6662,189,3222
All,2005 Q1,C,Manufacturing,Manufacture of coke and refined petroleum products; Manufacture of chemicals and chemical products,2487,1878,609,21,221
All,2005 Q1,C,Manufacturing,"Manufacture of pharmaceuticals, medicinal chemical and botanical products",2883,1350,1533,29,240
All,2005 Q1,C,Manufacturing,"Manufacture of rubber and plastics products (except furniture, toys, sports goods and stationery)",2934,1982,952,4,528
All,2005 Q1,C,Manufacturing,Manufacture of other non-metallic mineral products,1202,1039,163,17,208
All,2005 Q1,C,Manufacturing,Manufacture of basic metals,1142,934,208,10,73
All,2005 Q1,C,Manufacturing,Manufacture of fabricated metal products (except machinery and equipment),5520,3914,1606,32,1241
All,2005 Q1,C,Manufacturing,"Manufacture of computer, electronic and optical products",12503,6364,6139,160,341
All,2005 Q1,C,Manufacturing,Manufacture of electrical equipment,2888,1628,1260,30,252
All,2005 Q1,C,Manufacturing,Manufacture of machinery and equipment n.e.c.,2564,2284,280,13,696
All,2005 Q1,C,Manufacturing,Body assembly of motor vehicles; Manufacture of other transport equipment,1931,1484,447,33,89
All,2005 Q1,C,Manufacturing,Manufacture of furniture,306,260,46,0,138
All,2005 Q1,C,Manufacturing,Other manufacturing,9308,5872,3436,124,1619
All,2005 Q1,C,Manufacturing,Repair and installation of machinery and equipment,10511,8701,1810,376,1397
All,2005 Q1,B,Mining and quarrying,Quarrying and other mining of non-metal ores,130,124,6,0,6
All,2005 Q1,D,Electricity and gas supply,Electricity and gas supply,8090,6934,1156,3,16
All,2005 Q1,E,"Sewerage, waste management and remediation services",Sewerage,376,255,121,0,35
All,2005 Q1,E,"Sewerage, waste management and remediation services","Waste collection, treatment and disposal; materials recovery",1766,925,841,10,203
All,2005 Q1,E,"Sewerage, waste management and remediation services",Remediation and other waste management services,72,52,20,0,16
All,2005 Q1,F,Construction,Construction sites (manual workers only),65761,59823,5938,3,956
All,2005 Q1,F,Construction,Public sector sites,28704,27241,1463,3,354
All,2005 Q1,F,Construction,Public sector building sites,11482,10828,654,0,126
All,2005 Q1,F,Construction,Public sector civil engineering sites,17222,16413,809,3,228
All,2005 Q1,F,Construction,Private sector sites,37057,32582,4475,0,602
All,2005 Q1,F,Construction,Private sector building sites,33967,29692,4275,0,487
All,2005 Q1,F,Construction,Private sector civil engineering sites,3090,2890,200,0,115
All,2005 Q1,G,"Import/export, wholesale and retail trades",Import and export trade,511962,267742,244220,9123,96484
All,2005 Q1,G,"Import/export, wholesale and retail trades",Wholesale,69862,42586,27276,1116,15203
All,2005 Q1,G,"Import/export, wholesale and retail trades",Retail trade,212965,90075,122890,2976,53578
All,2005 Q1,H,"Transportation, storage, postal and courier services",Land transport,43372,37591,5781,284,2736
All,2005 Q1,H,"Transportation, storage, postal and courier services",Water transport,8800,5553,3247,46,280
All,2005 Q1,H,"Transportation, storage, postal and courier services",Air transport,17408,6771,10637,110,109
All,2005 Q1,H,"Transportation, storage, postal and courier services",Warehousing and support services for transportation,63394,39489,23905,841,4156
All,2005 Q1,H,"Transportation, storage, postal and courier services",Postal and courier services,10920,7298,3622,166,603
All,2005 Q1,I,Accommodation and food services,Accommodation services,26010,14681,11329,548,738
All,2005 Q1,I,Accommodation and food services,Food and beverage services,185854,87327,98527,1954,11600
All,2005 Q1,J,Information and communications,Publishing,18162,10127,8035,298,1205
All,2005 Q1,J,Information and communications,"Motion picture, video and television programme production, sound recording and music publishing; Programming and broadcasting",14809,9637,5172,97,1519
All,2005 Q1,J,Information and communications,Telecommunications,17045,10192,6853,209,319
All,2005 Q1,J,Information and communications,Information technology services,28650,21438,7212,806,4441
All,2005 Q1,J,Information and communications,Information services,2551,1329,1222,94,439
All,2005 Q1,K,Financing and insurance,Financial services (except insurance and pension funding),99029,45629,53400,1581,5174
All,2005 Q1,K,Financing and insurance,Insurance,12451,4715,7736,229,129
All,2005 Q1,K,Financing and insurance,Services auxiliary to financial and insurance services,40662,19919,20743,1511,9540
All,2005 Q1,L,Real estate,Real estate,90504,61230,29274,2460,9327
All,2005 Q1,M,"Professional, scientific and technical services",Legal and accounting services,37277,16564,20713,548,5352
All,2005 Q1,M,"Professional, scientific and technical services",Activities of head offices; management and management consultancy services,23902,11878,12024,830,3889
All,2005 Q1,M,"Professional, scientific and technical services","Architecture and engineering services, technical testing and analysis",26856,18376,8480,532,2518
All,2005 Q1,M,"Professional, scientific and technical services",Scientific research and development,618,415,203,27,43
All,2005 Q1,M,"Professional, scientific and technical services",Advertising and market research,11843,6587,5256,294,3079
All,2005 Q1,M,"Professional, scientific and technical services","Veterinary services; Other professional, scientific and technical services",15210,8612,6598,296,4751
All,2005 Q1,N,Administrative and support services,Rental and leasing services,1605,982,623,20,427
All,2005 Q1,N,Administrative and support services,Employment services,9026,3510,5516,212,1468
All,2005 Q1,N,Administrative and support services,"Travel agency, reservation service and related services",18575,7659,10916,416,2084
All,2005 Q1,N,Administrative and support services,Security and investigation services,35752,27315,8437,686,149
All,2005 Q1,N,Administrative and support services,Services to buildings and landscape care,54672,21671,33001,259,1267
All,2005 Q1,N,Administrative and support services,"Office administrative, office support and other business support services",19479,9850,9629,423,4021
All,2005 Q1,P,Education,Education,132946,49298,83648,1237,5444
All,2005 Q1,Q,Human health and social work services,Human health services,74795,21014,53781,1008,4986
All,2005 Q1,Q,Human health and social work services,Residential care services,24252,3514,20738,420,1022
All,2005 Q1,Q,Human health and social work services,Social work services,28506,6669,21837,347,1763
All,2005 Q1,R,"Arts, entertainment and recreation",Creative and performing arts activities,2209,1129,1080,34,559
All,2005 Q1,R,"Arts, entertainment and recreation","Libraries, archives, museums and other cultural activities",421,168,253,16,75
All,2005 Q1,R,"Arts, entertainment and recreation",Amusement parks and theme parks,0,0,0,0,0
All,2005 Q1,R,"Arts, entertainment and recreation",Sports and other entertainment services,0,0,0,0,0
All,2005 Q1,S,Other services,Activities of membership organisations,9363,3900,5463,171,885
All,2005 Q1,S,Other services,"Repair of motor vehicles, motorcycles, computers, personal and household goods",16764,13910,2854,215,4956
All,2005 Q1,S,Other services,Other personal services,36637,14044,22593,1563,8610
All,2005 Q2,C,Manufacturing,Manufacture of food products,19662,10808,8854,135,720
All,2005 Q2,C,Manufacturing,Manufacture of beverages,3400,2578,822,26,22
All,2005 Q2,C,Manufacturing,Manufacture of tobacco products,513,376,137,5,3
All,2005 Q2,C,Manufacturing,Manufacture of textiles,11153,6337,4816,51,963
All,2005 Q2,C,Manufacturing,Manufacture of wearing apparel,29025,7888,21137,316,1691
All,2005 Q2,C,Manufacturing,"Manufacture of leather and related products; Manufacture of wood and of products of wood and cork, articles of straw and plaiting materials (except furniture and toys)",570,423,147,4,192
All,2005 Q2,C,Manufacturing,Manufacture of paper and paper products,2310,1621,689,26,456
All,2005 Q2,C,Manufacturing,Printing and reproduction of recorded media,21533,14953,6580,201,3215
All,2005 Q2,C,Manufacturing,Manufacture of coke and refined petroleum products; Manufacture of chemicals and chemical products,2922,2019,903,10,260
All,2005 Q2,C,Manufacturing,"Manufacture of pharmaceuticals, medicinal chemical and botanical products",2258,963,1295,9,196
All,2005 Q2,C,Manufacturing,"Manufacture of rubber and plastics products (except furniture, toys, sports goods and stationery)",3030,2088,942,27,583
All,2005 Q2,C,Manufacturing,Manufacture of other non-metallic mineral products,1292,1083,209,4,219
All,2005 Q2,C,Manufacturing,Manufacture of basic metals,1228,1010,218,16,94
All,2005 Q2,C,Manufacturing,Manufacture of fabricated metal products (except machinery and equipment),5204,3773,1431,45,1157
All,2005 Q2,C,Manufacturing,"Manufacture of computer, electronic and optical products",11586,6069,5517,234,372
All,2005 Q2,C,Manufacturing,Manufacture of electrical equipment,3083,1687,1396,30,263
All,2005 Q2,C,Manufacturing,Manufacture of machinery and equipment n.e.c.,2804,2460,344,48,697
All,2005 Q2,C,Manufacturing,Body assembly of motor vehicles; Manufacture of other transport equipment,1886,1410,476,57,117
All,2005 Q2,C,Manufacturing,Manufacture of furniture,448,337,111,0,156
All,2005 Q2,C,Manufacturing,Other manufacturing,9597,6056,3541,128,1544
All,2005 Q2,C,Manufacturing,Repair and installation of machinery and equipment,10109,8347,1762,259,1310
All,2005 Q2,B,Mining and quarrying,Quarrying and other mining of non-metal ores,124,118,6,0,6
All,2005 Q2,D,Electricity and gas supply,Electricity and gas supply,8040,6881,1159,3,14
All,2005 Q2,E,"Sewerage, waste management and remediation services",Sewerage,123,33,90,0,35
All,2005 Q2,E,"Sewerage, waste management and remediation services","Waste collection, treatment and disposal; materials recovery",1506,763,743,5,197
All,2005 Q2,E,"Sewerage, waste management and remediation services",Remediation and other waste management services,53,52,1,0,13
All,2005 Q2,F,Construction,Construction sites (manual workers only),60001,55329,4672,9,951
All,2005 Q2,F,Construction,Public sector sites,26454,24750,1704,3,345
All,2005 Q2,F,Construction,Public sector building sites,10027,9192,835,0,126
All,2005 Q2,F,Construction,Public sector civil engineering sites,16427,15558,869,3,219
All,2005 Q2,F,Construction,Private sector sites,33547,30579,2968,6,606
All,2005 Q2,F,Construction,Private sector building sites,31266,28411,2855,6,488
All,2005 Q2,F,Construction,Private sector civil engineering sites,2281,2168,113,0,118
All,2005 Q2,G,"Import/export, wholesale and retail trades",Import and export trade,504930,263251,241679,8276,95787
All,2005 Q2,G,"Import/export, wholesale and retail trades",Wholesale,70980,43600,27380,1016,15347
All,2005 Q2,G,"Import/export, wholesale and retail trades",Retail trade,221943,92829,129114,3205,54330
All,2005 Q2,H,"Transportation, storage, postal and courier services",Land transport,44749,38788,5961,392,2649
All,2005 Q2,H,"Transportation, storage, postal and courier services",Water transport,8842,5607,3235,18,278
All,2005 Q2,H,"Transportation, storage, postal and courier services",Air transport,17614,6817,10797,126,109
All,2005 Q2,H,"Transportation, storage, postal and courier services",Warehousing and support services for transportation,62623,37961,24662,797,4150
All,2005 Q2,H,"Transportation, storage, postal and courier services",Postal and courier services,11321,7646,3675,160,614
All,2005 Q2,I,Accommodation and food services,Accommodation services,26291,14874,11417,546,731
All,2005 Q2,I,Accommodation and food services,Food and beverage services,189571,89949,99622,2236,11683
All,2005 Q2,J,Information and communications,Publishing,20307,11151,9156,238,1463
All,2005 Q2,J,Information and communications,"Motion picture, video and television programme production, sound recording and music publishing; Programming and broadcasting",14747,9402,5345,204,1599
All,2005 Q2,J,Information and communications,Telecommunications,17760,10897,6863,323,347
All,2005 Q2,J,Information and communications,Information technology services,28426,20994,7432,639,4488
All,2005 Q2,J,Information and communications,Information services,2310,1174,1136,118,424
All,2005 Q2,K,Financing and insurance,Financial services (except insurance and pension funding),100161,46182,53979,2038,5052
All,2005 Q2,K,Financing and insurance,Insurance,12581,4788,7793,278,136
All,2005 Q2,K,Financing and insurance,Services auxiliary to financial and insurance services,43553,21236,22317,2231,9251
All,2005 Q2,L,Real estate,Real estate,93266,63532,29734,2521,9465
All,2005 Q2,M,"Professional, scientific and technical services",Legal and accounting services,38032,17144,20888,473,5253
All,2005 Q2,M,"Professional, scientific and technical services",Activities of head offices; management and management consultancy services,25161,13418,11743,777,4133
All,2005 Q2,M,"Professional, scientific and technical services","Architecture and engineering services, technical testing and analysis",26468,17932,8536,398,2374
All,2005 Q2,M,"Professional, scientific and technical services",Scientific research and development,580,340,240,27,59
All,2005 Q2,M,"Professional, scientific and technical services",Advertising and market research,13293,7530,5763,362,3124
All,2005 Q2,M,"Professional, scientific and technical services","Veterinary services; Other professional, scientific and technical services",15758,9007,6751,322,4494
All,2005 Q2,N,Administrative and support services,Rental and leasing services,2104,1204,900,45,461
All,2005 Q2,N,Administrative and support services,Employment services,8133,2904,5229,131,1522
All,2005 Q2,N,Administrative and support services,"Travel agency, reservation service and related services",20044,8407,11637,551,2170
All,2005 Q2,N,Administrative and support services,Security and investigation services,36859,28930,7929,690,169
All,2005 Q2,N,Administrative and support services,Services to buildings and landscape care,55237,20611,34626,363,1230
All,2005 Q2,N,Administrative and support services,"Office administrative, office support and other business support services",18225,9230,8995,271,3577
All,2005 Q2,P,Education,Education,133343,49159,84184,1350,5550
All,2005 Q2,Q,Human health and social work services,Human health services,74972,21114,53858,1203,5190
All,2005 Q2,Q,Human health and social work services,Residential care services,23813,3381,20432,462,1061
All,2005 Q2,Q,Human health and social work services,Social work services,27578,6160,21418,380,1684
All,2005 Q2,R,"Arts, entertainment and recreation",Creative and performing arts activities,2238,1204,1034,8,628
All,2005 Q2,R,"Arts, entertainment and recreation","Libraries, archives, museums and other cultural activities",439,175,264,24,75
All,2005 Q2,R,"Arts, entertainment and recreation",Amusement parks and theme parks,0,0,0,0,0
All,2005 Q2,R,"Arts, entertainment and recreation",Sports and other entertainment services,0,0,0,0,0
All,2005 Q2,S,Other services,Activities of membership organisations,8509,3618,4891,173,876
All,2005 Q2,S,Other services,"Repair of motor vehicles, motorcycles, computers, personal and household goods",16857,13895,2962,298,5036
All,2005 Q2,S,Other services,Other personal services,38043,13703,24340,1253,8508
All,2005 Q3,C,Manufacturing,Manufacture of food products,21011,11797,9214,230,737
All,2005 Q3,C,Manufacturing,Manufacture of beverages,3508,2602,906,37,22
All,2005 Q3,C,Manufacturing,Manufacture of tobacco products,524,378,146,5,3
All,2005 Q3,C,Manufacturing,Manufacture of textiles,11197,6281,4916,52,928
All,2005 Q3,C,Manufacturing,Manufacture of wearing apparel,31833,7731,24102,574,1696
All,2005 Q3,C,Manufacturing,"Manufacture of leather and related products; Manufacture of wood and of products of wood and cork, articles of straw and plaiting materials (except furniture and toys)",529,409,120,11,178
All,2005 Q3,C,Manufacturing,Manufacture of paper and paper products,2066,1513,553,6,415
All,2005 Q3,C,Manufacturing,Printing and reproduction of recorded media,21235,14833,6402,134,3240
All,2005 Q3,C,Manufacturing,Manufacture of coke and refined petroleum products; Manufacture of chemicals and chemical products,2546,1814,732,28,228
All,2005 Q3,C,Manufacturing,"Manufacture of pharmaceuticals, medicinal chemical and botanical products",2864,1267,1597,18,236
All,2005 Q3,C,Manufacturing,"Manufacture of rubber and plastics products (except furniture, toys, sports goods and stationery)",2923,1975,948,27,555
All,2005 Q3,C,Manufacturing,Manufacture of other non-metallic mineral products,1287,1079,208,8,218
All,2005 Q3,C,Manufacturing,Manufacture of basic metals,1203,1011,192,10,81
All,2005 Q3,C,Manufacturing,Manufacture of fabricated metal products (except machinery and equipment),4746,3502,1244,31,1168
All,2005 Q3,C,Manufacturing,"Manufacture of computer, electronic and optical products",11914,6282,5632,227,406
All,2005 Q3,C,Manufacturing,Manufacture of electrical equipment,2971,1680,1291,7,279
All,2005 Q3,C,Manufacturing,Manufacture of machinery and equipment n.e.c.,2982,2494,488,32,733
All,2005 Q3,C,Manufacturing,Body assembly of motor vehicles; Manufacture of other transport equipment,2018,1533,485,27,101
All,2005 Q3,C,Manufacturing,Manufacture of furniture,439,353,86,11,143
All,2005 Q3,C,Manufacturing,Other manufacturing,9328,5873,3455,77,1586
All,2005 Q3,C,Manufacturing,Repair and installation of machinery and equipment,10490,8709,1781,231,1303
All,2005 Q3,B,Mining and quarrying,Quarrying and other mining of non-metal ores,124,120,4,0,6
All,2005 Q3,D,Electricity and gas supply,Electricity and gas supply,8023,6862,1161,12,14
All,2005 Q3,E,"Sewerage, waste management and remediation services",Sewerage,349,225,124,0,35
All,2005 Q3,E,"Sewerage, waste management and remediation services","Waste collection, treatment and disposal; materials recovery",1284,784,500,0,192
All,2005 Q3,E,"Sewerage, waste management and remediation services",Remediation and other waste management services,46,6,40,0,16
All,2005 Q3,F,Construction,Construction sites (manual workers only),56846,52126,4720,10,900
All,2005 Q3,F,Construction,Public sector sites,24306,22961,1345,7,323
All,2005 Q3,F,Construction,Public sector building sites,10571,9806,765,3,120
All,2005 Q3,F,Construction,Public sector civil engineering sites,13735,13155,580,4,203
All,2005 Q3,F,Construction,Private sector sites,32540,29165,3375,3,577
All,2005 Q3,F,Construction,Private sector building sites,30679,27414,3265,3,482
All,2005 Q3,F,Construction,Private sector civil engineering sites,1861,1751,110,0,95
All,2005 Q3,G,"Import/export, wholesale and retail trades",Import and export trade,514364,268179,246185,7921,98023
All,2005 Q3,G,"Import/export, wholesale and retail trades",Wholesale,69136,43130,26006,1097,14728
All,2005 Q3,G,"Import/export, wholesale and retail trades",Retail trade,218525,90429,128096,4704,54268
All,2005 Q3,H,"Transportation, storage, postal and courier services",Land transport,43727,38092,5635,376,2590
All,2005 Q3,H,"Transportation, storage, postal and courier services",Water transport,8814,5705,3109,52,322
All,2005 Q3,H,"Transportation, storage, postal and courier services",Air transport,18021,7009,11012,183,109
All,2005 Q3,H,"Transportation, storage, postal and courier services",Warehousing and support services for transportation,63009,38358,24651,779,4297
All,2005 Q3,H,"Transportation, storage, postal and courier services",Postal and courier services,11094,7249,3845,272,679
All,2005 Q3,I,Accommodation and food services,Accommodation services,28430,15946,12484,675,766
All,2005 Q3,I,Accommodation and food services,Food and beverage services,188515,87407,101108,3709,12180
All,2005 Q3,J,Information and communications,Publishing,20484,11607,8877,255,1437
All,2005 Q3,J,Information and communications,"Motion picture, video and television programme production, sound recording and music publishing; Programming and broadcasting",15049,9164,5885,159,1527
All,2005 Q3,J,Information and communications,Telecommunications,16676,10335,6341,819,312
All,2005 Q3,J,Information and communications,Information technology services,28081,21099,6982,796,4587
All,2005 Q3,J,Information and communications,Information services,2392,1384,1008,60,425
All,2005 Q3,K,Financing and insurance,Financial services (except insurance and pension funding),99593,45689,53904,2092,5389
All,2005 Q3,K,Financing and insurance,Insurance,12053,4560,7493,305,133
All,2005 Q3,K,Financing and insurance,Services auxiliary to financial and insurance services,43385,21405,21980,2467,9544
All,2005 Q3,L,Real estate,Real estate,94219,63368,30851,2599,9672
All,2005 Q3,M,"Professional, scientific and technical services",Legal and accounting services,36267,16095,20172,339,5405
All,2005 Q3,M,"Professional, scientific and technical services",Activities of head offices; management and management consultancy services,24204,11944,12260,792,4147
All,2005 Q3,M,"Professional, scientific and technical services","Architecture and engineering services, technical testing and analysis",27548,18635,8913,332,2514
All,2005 Q3,M,"Professional, scientific and technical services",Scientific research and development,651,394,257,25,43
All,2005 Q3,M,"Professional, scientific and technical services",Advertising and market research,12555,7098,5457,295,3112
All,2005 Q3,M,"Professional, scientific and technical services","Veterinary services; Other professional, scientific and technical services",15262,9041,6221,310,4688
All,2005 Q3,N,Administrative and support services,Rental and leasing services,1904,1149,755,26,507
All,2005 Q3,N,Administrative and support services,Employment services,9052,3845,5207,280,1539
All,2005 Q3,N,Administrative and support services,"Travel agency, reservation service and related services",20025,8279,11746,904,2136
All,2005 Q3,N,Administrative and support services,Security and investigation services,36202,27381,8821,1048,165
All,2005 Q3,N,Administrative and support services,Services to buildings and landscape care,57599,20703,36896,444,1225
All,2005 Q3,N,Administrative and support services,"Office administrative, office support and other business support services",18505,9144,9361,337,3939
All,2005 Q3,P,Education,Education,131069,49135,81934,1477,5690
All,2005 Q3,Q,Human health and social work services,Human health services,76253,21579,54674,861,5104
All,2005 Q3,Q,Human health and social work services,Residential care services,26080,3231,22849,595,1022
All,2005 Q3,Q,Human health and social work services,Social work services,26398,5681,20717,775,1766
All,2005 Q3,R,"Arts, entertainment and recreation",Creative and performing arts activities,1736,1028,708,81,382
All,2005 Q3,R,"Arts, entertainment and recreation","Libraries, archives, museums and other cultural activities",439,178,261,3,73
All,2005 Q3,R,"Arts, entertainment and recreation",Amusement parks and theme parks,0,0,0,0,0
All,2005 Q3,R,"Arts, entertainment and recreation",Sports and other entertainment services,0,0,0,0,0
All,2005 Q3,S,Other services,Activities of membership organisations,8556,3624,4932,198,925
All,2005 Q3,S,Other services,"Repair of motor vehicles, motorcycles, computers, personal and household goods",16446,13853,2593,205,4813
All,2005 Q3,S,Other services,Other personal services,37187,13900,23287,1493,8748
All,2005 Q4,C,Manufacturing,Manufacture of food products,21506,12022,9484,238,769
All,2005 Q4,C,Manufacturing,Manufacture of beverages,3469,2568,901,33,21
All,2005 Q4,C,Manufacturing,Manufacture of tobacco products,521,375,146,2,3
All,2005 Q4,C,Manufacturing,Manufacture of textiles,10918,6013,4905,21,962
All,2005 Q4,C,Manufacturing,Manufacture of wearing apparel,31055,7664,23391,726,1564
All,2005 Q4,C,Manufacturing,"Manufacture of leather and related products; Manufacture of wood and of products of wood and cork, articles of straw and plaiting materials (except furniture and toys)",500,391,109,2,176
All,2005 Q4,C,Manufacturing,Manufacture of paper and paper products,2034,1455,579,6,407
All,2005 Q4,C,Manufacturing,Printing and reproduction of recorded media,21491,14984,6507,169,3094
All,2005 Q4,C,Manufacturing,Manufacture of coke and refined petroleum products; Manufacture of chemicals and chemical products,2472,1729,743,153,237
All,2005 Q4,C,Manufacturing,"Manufacture of pharmaceuticals, medicinal chemical and botanical products",2823,1212,1611,52,214
All,2005 Q4,C,Manufacturing,"Manufacture of rubber and plastics products (except furniture, toys, sports goods and stationery)",3460,2209,1251,25,499
All,2005 Q4,C,Manufacturing,Manufacture of other non-metallic mineral products,1353,1134,219,10,214
All,2005 Q4,C,Manufacturing,Manufacture of basic metals,1205,1023,182,10,89
All,2005 Q4,C,Manufacturing,Manufacture of fabricated metal products (except machinery and equipment),4444,3464,980,44,1060
All,2005 Q4,C,Manufacturing,"Manufacture of computer, electronic and optical products",12119,6296,5823,189,386
All,2005 Q4,C,Manufacturing,Manufacture of electrical equipment,3027,1684,1343,16,268
All,2005 Q4,C,Manufacturing,Manufacture of machinery and equipment n.e.c.,2709,2348,361,18,690
All,2005 Q4,C,Manufacturing,Body assembly of motor vehicles; Manufacture of other transport equipment,1940,1503,437,11,93
All,2005 Q4,C,Manufacturing,Manufacture of furniture,496,391,105,4,155
All,2005 Q4,C,Manufacturing,Other manufacturing,9741,6125,3616,72,1590
All,2005 Q4,C,Manufacturing,Repair and installation of machinery and equipment,11113,9270,1843,181,1252
All,2005 Q4,B,Mining and quarrying,Quarrying and other mining of non-metal ores,128,122,6,0,6
All,2005 Q4,D,Electricity and gas supply,Electricity and gas supply,8002,6824,1178,9,14
All,2005 Q4,E,"Sewerage, waste management and remediation services",Sewerage,242,129,113,0,35
All,2005 Q4,E,"Sewerage, waste management and remediation services","Waste collection, treatment and disposal; materials recovery",1592,751,841,19,211
All,2005 Q4,E,"Sewerage, waste management and remediation services",Remediation and other waste management services,31,19,12,0,17
All,2005 Q4,F,Construction,Construction sites (manual workers only),54456,49590,4866,21,868
All,2005 Q4,F,Construction,Public sector sites,22586,21343,1243,16,319
All,2005 Q4,F,Construction,Public sector building sites,8459,7839,620,6,119
All,2005 Q4,F,Construction,Public sector civil engineering sites,14127,13504,623,10,200
All,2005 Q4,F,Construction,Private sector sites,31870,28247,3623,5,549
All,2005 Q4,F,Construction,Private sector building sites,30310,26761,3549,5,446
All,2005 Q4,F,Construction,Private sector civil engineering sites,1560,1486,74,0,103
All,2005 Q4,G,"Import/export, wholesale and retail trades",Import and export trade,509819,264207,245612,6926,97125
All,2005 Q4,G,"Import/export, wholesale and retail trades",Wholesale,68744,42047,26697,848,15009
All,2005 Q4,G,"Import/export, wholesale and retail trades",Retail trade,219495,92801,126694,3620,55132
All,2005 Q4,H,"Transportation, storage, postal and courier services",Land transport,43791,37497,6294,263,2551
All,2005 Q4,H,"Transportation, storage, postal and courier services",Water transport,8363,5263,3100,50,275
All,2005 Q4,H,"Transportation, storage, postal and courier services",Air transport,18149,7082,11067,82,111
All,2005 Q4,H,"Transportation, storage, postal and courier services",Warehousing and support services for transportation,64851,39954,24897,680,4507
All,2005 Q4,H,"Transportation, storage, postal and courier services",Postal and courier services,11321,7437,3884,151,640
All,2005 Q4,I,Accommodation and food services,Accommodation services,28376,15933,12443,524,717
All,2005 Q4,I,Accommodation and food services,Food and beverage services,194846,91824,103022,3722,12127
All,2005 Q4,J,Information and communications,Publishing,19932,11208,8724,235,1513
All,2005 Q4,J,Information and communications,"Motion picture, video and television programme production, sound recording and music publishing; Programming and broadcasting",13997,8859,5138,67,1462
All,2005 Q4,J,Information and communications,Telecommunications,15668,9939,5729,530,296
All,2005 Q4,J,Information and communications,Information technology services,30312,23157,7155,616,4576
All,2005 Q4,J,Information and communications,Information services,2425,1250,1175,55,347
All,2005 Q4,K,Financing and insurance,Financial services (except insurance and pension funding),100696,45954,54742,2150,5411
All,2005 Q4,K,Financing and insurance,Insurance,11996,4600,7396,284,123
All,2005 Q4,K,Financing and insurance,Services auxiliary to financial and insurance services,44705,21575,23130,1507,9585
All,2005 Q4,L,Real estate,Real estate,96333,65536,30797,1990,10001
All,2005 Q4,M,"Professional, scientific and technical services",Legal and accounting services,37594,16544,21050,348,5573
All,2005 Q4,M,"Professional, scientific and technical services",Activities of head offices; management and management consultancy services,23382,11839,11543,479,4067
All,2005 Q4,M,"Professional, scientific and technical services","Architecture and engineering services, technical testing and analysis",26935,18111,8824,404,2528
All,2005 Q4,M,"Professional, scientific and technical services",Scientific research and development,672,377,295,33,40
All,2005 Q4,M,"Professional, scientific and technical services",Advertising and market research,11965,6851,5114,304,3107
All,2005 Q4,M,"Professional, scientific and technical services","Veterinary services; Other professional, scientific and technical services",16343,9233,7110,382,4821
All,2005 Q4,N,Administrative and support services,Rental and leasing services,1828,1105,723,36,527
All,2005 Q4,N,Administrative and support services,Employment services,10741,4537,6204,392,1516
All,2005 Q4,N,Administrative and support services,"Travel agency, reservation service and related services",19612,7946,11666,399,2154
All,2005 Q4,N,Administrative and support services,Security and investigation services,38653,29797,8856,573,227
All,2005 Q4,N,Administrative and support services,Services to buildings and landscape care,56501,19742,36759,467,1242
All,2005 Q4,N,Administrative and support services,"Office administrative, office support and other business support services",17219,8444,8775,412,3873
All,2005 Q4,P,Education,Education,138131,50733,87398,1380,5992
All,2005 Q4,Q,Human health and social work services,Human health services,75943,21112,54831,668,5269
All,2005 Q4,Q,Human health and social work services,Residential care services,25705,3272,22433,506,1081
All,2005 Q4,Q,Human health and social work services,Social work services,27964,6113,21851,656,1755
All,2005 Q4,R,"Arts, entertainment and recreation",Creative and performing arts activities,2361,1422,939,18,543
All,2005 Q4,R,"Arts, entertainment and recreation","Libraries, archives, museums and other cultural activities",424,158,266,7,66
All,2005 Q4,R,"Arts, entertainment and recreation",Amusement parks and theme parks,0,0,0,0,0
All,2005 Q4,R,"Arts, entertainment and recreation",Sports and other entertainment services,0,0,0,0,0
All,2005 Q4,S,Other services,Activities of membership organisations,8409,3407,5002,145,899
All,2005 Q4,S,Other services,"Repair of motor vehicles, motorcycles, computers, personal and household goods",17175,14339,2836,134,5047
All,2005 Q4,S,Other services,Other personal services,35828,12528,23300,1074,8680
All,2006 Q1,C,Manufacturing,Manufacture of food products,21082,11678,9404,393,739
All,2006 Q1,C,Manufacturing,Manufacture of beverages,3462,2576,886,37,22
All,2006 Q1,C,Manufacturing,Manufacture of tobacco products,514,371,143,5,3
All,2006 Q1,C,Manufacturing,Manufacture of textiles,10333,5811,4522,55,888
All,2006 Q1,C,Manufacturing,Manufacture of wearing apparel,29138,7622,21516,423,1676
All,2006 Q1,C,Manufacturing,"Manufacture of leather and related products; Manufacture of wood and of products of wood and cork, articles of straw and plaiting materials (except furniture and toys)",569,429,140,0,166
All,2006 Q1,C,Manufacturing,Manufacture of paper and paper products,1935,1379,556,0,414
All,2006 Q1,C,Manufacturing,Printing and reproduction of recorded media,21996,15166,6830,110,3161
All,2006 Q1,C,Manufacturing,Manufacture of coke and refined petroleum products; Manufacture of chemicals and chemical products,2054,1519,535,19,200
All,2006 Q1,C,Manufacturing,"Manufacture of pharmaceuticals, medicinal chemical and botanical products",2816,1255,1561,27,232
All,2006 Q1,C,Manufacturing,"Manufacture of rubber and plastics products (except furniture, toys, sports goods and stationery)",3066,1971,1095,25,518
All,2006 Q1,C,Manufacturing,Manufacture of other non-metallic mineral products,1106,959,147,0,192
All,2006 Q1,C,Manufacturing,Manufacture of basic metals,1279,1054,225,5,78
All,2006 Q1,C,Manufacturing,Manufacture of fabricated metal products (except machinery and equipment),5023,3781,1242,8,1161
All,2006 Q1,C,Manufacturing,"Manufacture of computer, electronic and optical products",11157,5965,5192,161,362
All,2006 Q1,C,Manufacturing,Manufacture of electrical equipment,3106,1744,1362,10,284
All,2006 Q1,C,Manufacturing,Manufacture of machinery and equipment n.e.c.,2456,2030,426,5,733
All,2006 Q1,C,Manufacturing,Body assembly of motor vehicles; Manufacture of other transport equipment,2008,1537,471,9,99
All,2006 Q1,C,Manufacturing,Manufacture of furniture,406,302,104,6,145
All,2006 Q1,C,Manufacturing,Other manufacturing,9561,5957,3604,52,1583
All,2006 Q1,C,Manufacturing,Repair and installation of machinery and equipment,10716,8934,1782,368,1334
All,2006 Q1,B,Mining and quarrying,Quarrying and other mining of non-metal ores,128,122,6,0,6
All,2006 Q1,D,Electricity and gas supply,Electricity and gas supply,8011,6824,1187,2,15
All,2006 Q1,E,"Sewerage, waste management and remediation services",Sewerage,281,185,96,0,34
All,2006 Q1,E,"Sewerage, waste management and remediation services","Waste collection, treatment and disposal; materials recovery",1390,823,567,20,206
All,2006 Q1,E,"Sewerage, waste management and remediation services",Remediation and other waste management services,40,32,8,0,16
All,2006 Q1,F,Construction,Construction sites (manual workers only),54897,50540,4357,5,886
All,2006 Q1,F,Construction,Public sector sites,21147,20054,1093,3,318
All,2006 Q1,F,Construction,Public sector building sites,8312,7813,499,0,121
All,2006 Q1,F,Construction,Public sector civil engineering sites,12835,12241,594,3,197
All,2006 Q1,F,Construction,Private sector sites,33750,30486,3264,2,568
All,2006 Q1,F,Construction,Private sector building sites,32156,28935,3221,2,465
All,2006 Q1,F,Construction,Private sector civil engineering sites,1594,1551,43,0,103
All,2006 Q1,G,"Import/export, wholesale and retail trades",Import and export trade,512424,266239,246185,9518,98535
All,2006 Q1,G,"Import/export, wholesale and retail trades",Wholesale,67360,41637,25723,1030,15414
All,2006 Q1,G,"Import/export, wholesale and retail trades",Retail trade,222503,93684,128819,4711,56595
All,2006 Q1,H,"Transportation, storage, postal and courier services",Land transport,42688,37229,5459,456,2743
All,2006 Q1,H,"Transportation, storage, postal and courier services",Water transport,8659,5591,3068,93,313
All,2006 Q1,H,"Transportation, storage, postal and courier services",Air transport,18520,7235,11285,133,113
All,2006 Q1,H,"Transportation, storage, postal and courier services",Warehousing and support services for transportation,65012,40123,24889,827,4459
All,2006 Q1,H,"Transportation, storage, postal and courier services",Postal and courier services,11324,7820,3504,124,635
All,2006 Q1,I,Accommodation and food services,Accommodation services,28420,16033,12387,608,773
All,2006 Q1,I,Accommodation and food services,Food and beverage services,196227,92504,103723,3490,12191
All,2006 Q1,J,Information and communications,Publishing,18581,10687,7894,213,1428
All,2006 Q1,J,Information and communications,"Motion picture, video and television programme production, sound recording and music publishing; Programming and broadcasting",15321,9641,5680,106,1603
All,2006 Q1,J,Information and communications,Telecommunications,16738,10530,6208,583,281
All,2006 Q1,J,Information and communications,Information technology services,30251,22330,7921,1425,4804
All,2006 Q1,J,Information and communications,Information services,2492,1423,1069,69,557
All,2006 Q1,K,Financing and insurance,Financial services (except insurance and pension funding),102406,47310,55096,2535,5230
All,2006 Q1,K,Financing and insurance,Insurance,11636,4430,7206,272,123
All,2006 Q1,K,Financing and insurance,Services auxiliary to financial and insurance services,43876,21745,22131,1931,9733
All,2006 Q1,L,Real estate,Real estate,97884,64399,33485,3396,10331
All,2006 Q1,M,"Professional, scientific and technical services",Legal and accounting services,37060,16188,20872,575,5579
All,2006 Q1,M,"Professional, scientific and technical services",Activities of head offices; management and management consultancy services,26506,12863,13643,509,4254
All,2006 Q1,M,"Professional, scientific and technical services","Architecture and engineering services, technical testing and analysis",27027,18602,8425,486,2594
All,2006 Q1,M,"Professional, scientific and technical services",Scientific research and development,680,404,276,25,39
All,2006 Q1,M,"Professional, scientific and technical services",Advertising and market research,13053,7614,5439,457,3371
All,2006 Q1,M,"Professional, scientific and technical services","Veterinary services; Other professional, scientific and technical services",15438,8558,6880,239,5002
All,2006 Q1,N,Administrative and support services,Rental and leasing services,1493,965,528,35,460
All,2006 Q1,N,Administrative and support services,Employment services,9834,3738,6096,441,1693
All,2006 Q1,N,Administrative and support services,"Travel agency, reservation service and related services",19499,7652,11847,526,2185
All,2006 Q1,N,Administrative and support services,Security and investigation services,37535,29072,8463,699,170
All,2006 Q1,N,Administrative and support services,Services to buildings and landscape care,57565,19897,37668,515,1205
All,2006 Q1,N,Administrative and support services,"Office administrative, office support and other business support services",18375,9372,9003,583,3893
All,2006 Q1,P,Education,Education,138218,52309,85909,1518,6168
All,2006 Q1,Q,Human health and social work services,Human health services,76700,21340,55360,1399,5375
All,2006 Q1,Q,Human health and social work services,Residential care services,25797,3373,22424,636,1096
All,2006 Q1,Q,Human health and social work services,Social work services,28242,6067,22175,775,1716
All,2006 Q1,R,"Arts, entertainment and recreation",Creative and performing arts activities,2254,1278,976,49,570
All,2006 Q1,R,"Arts, entertainment and recreation","Libraries, archives, museums and other cultural activities",396,142,254,6,67
All,2006 Q1,R,"Arts, entertainment and recreation",Amusement parks and theme parks,5538,2956,2582,123,5
All,2006 Q1,R,"Arts, entertainment and recreation",Sports and other entertainment services,32455,16818,15637,1124,790
All,2006 Q1,S,Other services,Activities of membership organisations,9042,3945,5097,123,936
All,2006 Q1,S,Other services,"Repair of motor vehicles, motorcycles, computers, personal and household goods",16223,13567,2656,238,4950
All,2006 Q1,S,Other services,Other personal services,37439,13870,23569,1190,9056
All,2006 Q2,C,Manufacturing,Manufacture of food products,20442,11525,8917,172,746
All,2006 Q2,C,Manufacturing,Manufacture of beverages,3507,2644,863,23,26
All,2006 Q2,C,Manufacturing,Manufacture of tobacco products,507,363,144,22,3
All,2006 Q2,C,Manufacturing,Manufacture of textiles,10463,5916,4547,117,872
All,2006 Q2,C,Manufacturing,Manufacture of wearing apparel,29467,7856,21611,419,1660
All,2006 Q2,C,Manufacturing,"Manufacture of leather and related products; Manufacture of wood and of products of wood and cork, articles of straw and plaiting materials (except furniture and toys)",414,339,75,0,150
All,2006 Q2,C,Manufacturing,Manufacture of paper and paper products,1905,1301,604,10,397
All,2006 Q2,C,Manufacturing,Printing and reproduction of recorded media,20542,14422,6120,113,3122
All,2006 Q2,C,Manufacturing,Manufacture of coke and refined petroleum products; Manufacture of chemicals and chemical products,2510,1782,728,16,206
All,2006 Q2,C,Manufacturing,"Manufacture of pharmaceuticals, medicinal chemical and botanical products",2766,1196,1570,28,227
All,2006 Q2,C,Manufacturing,"Manufacture of rubber and plastics products (except furniture, toys, sports goods and stationery)",3005,2022,983,14,511
All,2006 Q2,C,Manufacturing,Manufacture of other non-metallic mineral products,1175,1009,166,8,195
All,2006 Q2,C,Manufacturing,Manufacture of basic metals,1214,848,366,12,77
All,2006 Q2,C,Manufacturing,Manufacture of fabricated metal products (except machinery and equipment),4739,3457,1282,55,1066
All,2006 Q2,C,Manufacturing,"Manufacture of computer, electronic and optical products",10838,5743,5095,140,357
All,2006 Q2,C,Manufacturing,Manufacture of electrical equipment,2660,1498,1162,46,252
All,2006 Q2,C,Manufacturing,Manufacture of machinery and equipment n.e.c.,2494,2072,422,43,684
All,2006 Q2,C,Manufacturing,Body assembly of motor vehicles; Manufacture of other transport equipment,1985,1558,427,34,94
All,2006 Q2,C,Manufacturing,Manufacture of furniture,476,388,88,0,172
All,2006 Q2,C,Manufacturing,Other manufacturing,9156,5643,3513,63,1523
All,2006 Q2,C,Manufacturing,Repair and installation of machinery and equipment,11042,9150,1892,372,1334
All,2006 Q2,B,Mining and quarrying,Quarrying and other mining of non-metal ores,130,122,8,0,6
All,2006 Q2,D,Electricity and gas supply,Electricity and gas supply,8008,6786,1222,5,15
All,2006 Q2,E,"Sewerage, waste management and remediation services",Sewerage,207,120,87,0,37
All,2006 Q2,E,"Sewerage, waste management and remediation services","Waste collection, treatment and disposal; materials recovery",1562,1067,495,12,222
All,2006 Q2,E,"Sewerage, waste management and remediation services",Remediation and other waste management services,77,17,60,0,17
All,2006 Q2,F,Construction,Construction sites (manual workers only),52273,48120,4153,9,933
All,2006 Q2,F,Construction,Public sector sites,19569,18498,1071,9,322
All,2006 Q2,F,Construction,Public sector building sites,7822,7295,527,9,108
All,2006 Q2,F,Construction,Public sector civil engineering sites,11747,11203,544,0,214
All,2006 Q2,F,Construction,Private sector sites,32704,29622,3082,0,611
All,2006 Q2,F,Construction,Private sector building sites,30997,27985,3012,0,486
All,2006 Q2,F,Construction,Private sector civil engineering sites,1707,1637,70,0,125
All,2006 Q2,G,"Import/export, wholesale and retail trades",Import and export trade,513057,265292,247765,7441,98931
All,2006 Q2,G,"Import/export, wholesale and retail trades",Wholesale,67264,42942,24322,874,15239
All,2006 Q2,G,"Import/export, wholesale and retail trades",Retail trade,225754,92938,132816,3687,56064
All,2006 Q2,H,"Transportation, storage, postal and courier services",Land transport,42874,37171,5703,449,2696
All,2006 Q2,H,"Transportation, storage, postal and courier services",Water transport,8695,5664,3031,153,302
All,2006 Q2,H,"Transportation, storage, postal and courier services",Air transport,18896,7289,11607,160,113
All,2006 Q2,H,"Transportation, storage, postal and courier services",Warehousing and support services for transportation,64729,40242,24487,984,4447
All,2006 Q2,H,"Transportation, storage, postal and courier services",Postal and courier services,11397,7585,3812,303,636
All,2006 Q2,I,Accommodation and food services,Accommodation services,28824,15804,13020,558,776
All,2006 Q2,I,Accommodation and food services,Food and beverage services,199102,94050,105052,3542,12394
All,2006 Q2,J,Information and communications,Publishing,20396,11315,9081,229,1398
All,2006 Q2,J,Information and communications,"Motion picture, video and television programme production, sound recording and music publishing; Programming and broadcasting",14711,9353,5358,238,1694
All,2006 Q2,J,Information and communications,Telecommunications,16074,10019,6055,469,293
All,2006 Q2,J,Information and communications,Information technology services,30329,22578,7751,963,4817
All,2006 Q2,J,Information and communications,Information services,2641,1453,1188,81,482
All,2006 Q2,K,Financing and insurance,Financial services (except insurance and pension funding),103554,48264,55290,2314,5223
All,2006 Q2,K,Financing and insurance,Insurance,11912,4493,7419,376,152
All,2006 Q2,K,Financing and insurance,Services auxiliary to financial and insurance services,45158,21558,23600,1892,9804
All,2006 Q2,L,Real estate,Real estate,98760,65550,33210,2959,10335
All,2006 Q2,M,"Professional, scientific and technical services",Legal and accounting services,40169,17842,22327,685,5581
All,2006 Q2,M,"Professional, scientific and technical services",Activities of head offices; management and management consultancy services,25185,12846,12339,739,4400
All,2006 Q2,M,"Professional, scientific and technical services","Architecture and engineering services, technical testing and analysis",27091,18379,8712,411,2539
All,2006 Q2,M,"Professional, scientific and technical services",Scientific research and development,648,419,229,103,33
All,2006 Q2,M,"Professional, scientific and technical services",Advertising and market research,13388,7471,5917,347,3287
All,2006 Q2,M,"Professional, scientific and technical services","Veterinary services; Other professional, scientific and technical services",15032,8989,6043,375,4978
All,2006 Q2,N,Administrative and support services,Rental and leasing services,1499,965,534,5,512
All,2006 Q2,N,Administrative and support services,Employment services,9301,3907,5394,262,1659
All,2006 Q2,N,Administrative and support services,"Travel agency, reservation service and related services",20071,8416,11655,465,2185
All,2006 Q2,N,Administrative and support services,Security and investigation services,36896,28192,8704,753,186
All,2006 Q2,N,Administrative and support services,Services to buildings and landscape care,56108,20914,35194,478,1257
All,2006 Q2,N,Administrative and support services,"Office administrative, office support and other business support services",21477,10930,10547,239,4122
All,2006 Q2,P,Education,Education,138884,50780,88104,1979,6298
All,2006 Q2,Q,Human health and social work services,Human health services,78446,22001,56445,1522,5515
All,2006 Q2,Q,Human health and social work services,Residential care services,24410,2852,21558,723,993
All,2006 Q2,Q,Human health and social work services,Social work services,29040,6736,22304,403,1823
All,2006 Q2,R,"Arts, entertainment and recreation",Creative and performing arts activities,2516,1417,1099,123,578
All,2006 Q2,R,"Arts, entertainment and recreation","Libraries, archives, museums and other cultural activities",421,156,265,6,74
All,2006 Q2,R,"Arts, entertainment and recreation",Amusement parks and theme parks,5801,3092,2709,94,5
All,2006 Q2,R,"Arts, entertainment and recreation",Sports and other entertainment services,32543,16873,15670,608,795
All,2006 Q2,S,Other services,Activities of membership organisations,9049,3927,5122,160,951
All,2006 Q2,S,Other services,"Repair of motor vehicles, motorcycles, computers, personal and household goods",16552,13740,2812,363,4994
All,2006 Q2,S,Other services,Other personal services,38145,13545,24600,1266,9098
All,2006 Q3,C,Manufacturing,Manufacture of food products,22797,12097,10700,231,769
All,2006 Q3,C,Manufacturing,Manufacture of beverages,3386,2488,898,48,23
All,2006 Q3,C,Manufacturing,Manufacture of tobacco products,505,358,147,9,3
All,2006 Q3,C,Manufacturing,Manufacture of textiles,10112,5478,4634,43,865
All,2006 Q3,C,Manufacturing,Manufacture of wearing apparel,27553,7634,19919,455,1652
All,2006 Q3,C,Manufacturing,"Manufacture of leather and related products; Manufacture of wood and of products of wood and cork, articles of straw and plaiting materials (except furniture and toys)",449,325,124,8,165
All,2006 Q3,C,Manufacturing,Manufacture of paper and paper products,1745,1241,504,4,377
All,2006 Q3,C,Manufacturing,Printing and reproduction of recorded media,21522,14310,7212,226,3133
All,2006 Q3,C,Manufacturing,Manufacture of coke and refined petroleum products; Manufacture of chemicals and chemical products,2199,1533,666,31,190
All,2006 Q3,C,Manufacturing,"Manufacture of pharmaceuticals, medicinal chemical and botanical products",2785,1251,1534,0,213
All,2006 Q3,C,Manufacturing,"Manufacture of rubber and plastics products (except furniture, toys, sports goods and stationery)",2870,1886,984,38,515
All,2006 Q3,C,Manufacturing,Manufacture of other non-metallic mineral products,1157,930,227,1,206
All,2006 Q3,C,Manufacturing,Manufacture of basic metals,1178,988,190,23,73
All,2006 Q3,C,Manufacturing,Manufacture of fabricated metal products (except machinery and equipment),5130,3838,1292,34,1077
All,2006 Q3,C,Manufacturing,"Manufacture of computer, electronic and optical products",9906,5538,4368,153,367
All,2006 Q3,C,Manufacturing,Manufacture of electrical equipment,2837,1762,1075,32,272
All,2006 Q3,C,Manufacturing,Manufacture of machinery and equipment n.e.c.,2271,1910,361,8,592
All,2006 Q3,C,Manufacturing,Body assembly of motor vehicles; Manufacture of other transport equipment,1771,1332,439,36,96
All,2006 Q3,C,Manufacturing,Manufacture of furniture,460,347,113,12,138
All,2006 Q3,C,Manufacturing,Other manufacturing,9591,5816,3775,56,1572
All,2006 Q3,C,Manufacturing,Repair and installation of machinery and equipment,11228,9448,1780,193,1316
All,2006 Q3,B,Mining and quarrying,Quarrying and other mining of non-metal ores,128,122,6,0,6
All,2006 Q3,D,Electricity and gas supply,Electricity and gas supply,7975,6772,1203,20,15
All,2006 Q3,E,"Sewerage, waste management and remediation services",Sewerage,164,82,82,0,37
All,2006 Q3,E,"Sewerage, waste management and remediation services","Waste collection, treatment and disposal; materials recovery",1460,972,488,11,218
All,2006 Q3,E,"Sewerage, waste management and remediation services",Remediation and other waste management services,46,42,4,1,16
All,2006 Q3,F,Construction,Construction sites (manual workers only),53286,49272,4014,10,914
All,2006 Q3,F,Construction,Public sector sites,20485,19522,963,5,299
All,2006 Q3,F,Construction,Public sector building sites,7588,7136,452,0,94
All,2006 Q3,F,Construction,Public sector civil engineering sites,12897,12386,511,5,205
All,2006 Q3,F,Construction,Private sector sites,32801,29750,3051,5,615
All,2006 Q3,F,Construction,Private sector building sites,31261,28277,2984,5,514
All,2006 Q3,F,Construction,Private sector civil engineering sites,1540,1473,67,0,101
All,2006 Q3,G,"Import/export, wholesale and retail trades",Import and export trade,516926,268010,248916,6978,99012
All,2006 Q3,G,"Import/export, wholesale and retail trades",Wholesale,65841,41171,24670,752,15201
All,2006 Q3,G,"Import/export, wholesale and retail trades",Retail trade,225344,93422,131922,4165,56291
All,2006 Q3,H,"Transportation, storage, postal and courier services",Land transport,43100,37207,5893,420,2716
All,2006 Q3,H,"Transportation, storage, postal and courier services",Water transport,8545,5309,3236,120,302
All,2006 Q3,H,"Transportation, storage, postal and courier services",Air transport,18729,7328,11401,105,117
All,2006 Q3,H,"Transportation, storage, postal and courier services",Warehousing and support services for transportation,65490,40807,24683,824,4352
All,2006 Q3,H,"Transportation, storage, postal and courier services",Postal and courier services,12089,8227,3862,224,647
All,2006 Q3,I,Accommodation and food services,Accommodation services,30099,16730,13369,477,771
All,2006 Q3,I,Accommodation and food services,Food and beverage services,198442,92466,105976,4751,12420
All,2006 Q3,J,Information and communications,Publishing,20297,11425,8872,324,1422
All,2006 Q3,J,Information and communications,"Motion picture, video and television programme production, sound recording and music publishing; Programming and broadcasting",14235,9077,5158,223,1568
All,2006 Q3,J,Information and communications,Telecommunications,15311,9544,5767,325,305
All,2006 Q3,J,Information and communications,Information technology services,30921,22855,8066,730,4889
All,2006 Q3,J,Information and communications,Information services,2426,1369,1057,43,550
All,2006 Q3,K,Financing and insurance,Financial services (except insurance and pension funding),106247,49183,57064,2702,5439
All,2006 Q3,K,Financing and insurance,Insurance,11425,4472,6953,157,117
All,2006 Q3,K,Financing and insurance,Services auxiliary to financial and insurance services,45557,22232,23325,2259,10210
All,2006 Q3,L,Real estate,Real estate,98092,65942,32150,2978,10519
All,2006 Q3,M,"Professional, scientific and technical services",Legal and accounting services,40279,18243,22036,611,5599
All,2006 Q3,M,"Professional, scientific and technical services",Activities of head offices; management and management consultancy services,24600,12318,12282,614,4370
All,2006 Q3,M,"Professional, scientific and technical services","Architecture and engineering services, technical testing and analysis",27507,18247,9260,549,2580
All,2006 Q3,M,"Professional, scientific and technical services",Scientific research and development,728,477,251,196,35
All,2006 Q3,M,"Professional, scientific and technical services",Advertising and market research,14431,8201,6230,384,3292
All,2006 Q3,M,"Professional, scientific and technical services","Veterinary services; Other professional, scientific and technical services",15402,8604,6798,360,4986
All,2006 Q3,N,Administrative and support services,Rental and leasing services,1846,1209,637,145,540
All,2006 Q3,N,Administrative and support services,Employment services,10161,4238,5923,248,1759
All,2006 Q3,N,Administrative and support services,"Travel agency, reservation service and related services",20542,9335,11207,389,2238
All,2006 Q3,N,Administrative and support services,Security and investigation services,38109,28916,9193,748,169
All,2006 Q3,N,Administrative and support services,Services to buildings and landscape care,57812,20981,36831,268,1230
All,2006 Q3,N,Administrative and support services,"Office administrative, office support and other business support services",20598,10314,10284,595,4068
All,2006 Q3,P,Education,Education,141224,50889,90335,2138,6406
All,2006 Q3,Q,Human health and social work services,Human health services,79089,21850,57239,1144,5570
All,2006 Q3,Q,Human health and social work services,Residential care services,24793,3647,21146,644,1106
All,2006 Q3,Q,Human health and social work services,Social work services,27619,6307,21312,831,1756
All,2006 Q3,R,"Arts, entertainment and recreation",Creative and performing arts activities,2833,1623,1210,35,673
All,2006 Q3,R,"Arts, entertainment and recreation","Libraries, archives, museums and other cultural activities",425,160,265,9,79
All,2006 Q3,R,"Arts, entertainment and recreation",Amusement parks and theme parks,4935,2652,2283,151,5
All,2006 Q3,R,"Arts, entertainment and recreation",Sports and other entertainment services,31738,16183,15555,1122,845
All,2006 Q3,S,Other services,Activities of membership organisations,8972,3836,5136,192,941
All,2006 Q3,S,Other services,"Repair of motor vehicles, motorcycles, computers, personal and household goods",15854,12979,2875,264,5067
All,2006 Q3,S,Other services,Other personal services,38655,13149,25506,1746,9146
All,2006 Q4,C,Manufacturing,Manufacture of food products,22439,12650,9789,234,748
All,2006 Q4,C,Manufacturing,Manufacture of beverages,3461,2559,902,46,27
All,2006 Q4,C,Manufacturing,Manufacture of tobacco products,475,333,142,5,3
All,2006 Q4,C,Manufacturing,Manufacture of textiles,10096,5465,4631,44,873
All,2006 Q4,C,Manufacturing,Manufacture of wearing apparel,26313,7070,19243,370,1624
All,2006 Q4,C,Manufacturing,"Manufacture of leather and related products; Manufacture of wood and of products of wood and cork, articles of straw and plaiting materials (except furniture and toys)",488,393,95,0,154
All,2006 Q4,C,Manufacturing,Manufacture of paper and paper products,1705,1237,468,12,386
All,2006 Q4,C,Manufacturing,Printing and reproduction of recorded media,21631,15216,6415,118,3140
All,2006 Q4,C,Manufacturing,Manufacture of coke and refined petroleum products; Manufacture of chemicals and chemical products,2317,1551,766,13,207
All,2006 Q4,C,Manufacturing,"Manufacture of pharmaceuticals, medicinal chemical and botanical products",2758,1180,1578,7,217
All,2006 Q4,C,Manufacturing,"Manufacture of rubber and plastics products (except furniture, toys, sports goods and stationery)",2520,1701,819,10,497
All,2006 Q4,C,Manufacturing,Manufacture of other non-metallic mineral products,1277,1113,164,6,214
All,2006 Q4,C,Manufacturing,Manufacture of basic metals,1293,1074,219,8,73
All,2006 Q4,C,Manufacturing,Manufacture of fabricated metal products (except machinery and equipment),4520,3463,1057,8,1081
All,2006 Q4,C,Manufacturing,"Manufacture of computer, electronic and optical products",9603,5248,4355,113,336
All,2006 Q4,C,Manufacturing,Manufacture of electrical equipment,2486,1375,1111,19,280
All,2006 Q4,C,Manufacturing,Manufacture of machinery and equipment n.e.c.,2488,2046,442,79,612
All,2006 Q4,C,Manufacturing,Body assembly of motor vehicles; Manufacture of other transport equipment,1548,1195,353,13,89
All,2006 Q4,C,Manufacturing,Manufacture of furniture,474,401,73,0,141
All,2006 Q4,C,Manufacturing,Other manufacturing,9540,6014,3526,43,1528
All,2006 Q4,C,Manufacturing,Repair and installation of machinery and equipment,12115,10169,1946,240,1419
All,2006 Q4,B,Mining and quarrying,Quarrying and other mining of non-metal ores,116,111,5,0,6
All,2006 Q4,D,Electricity and gas supply,Electricity and gas supply,7926,6736,1190,10,15
All,2006 Q4,E,"Sewerage, waste management and remediation services",Sewerage,718,574,144,0,34
All,2006 Q4,E,"Sewerage, waste management and remediation services","Waste collection, treatment and disposal; materials recovery",1591,963,628,10,207
All,2006 Q4,E,"Sewerage, waste management and remediation services",Remediation and other waste management services,24,11,13,0,15
All,2006 Q4,F,Construction,Construction sites (manual workers only),51004,47621,3383,16,911
All,2006 Q4,F,Construction,Public sector sites,20014,19065,949,14,330
All,2006 Q4,F,Construction,Public sector building sites,6850,6423,427,11,97
All,2006 Q4,F,Construction,Public sector civil engineering sites,13164,12642,522,3,233
All,2006 Q4,F,Construction,Private sector sites,30990,28556,2434,2,581
All,2006 Q4,F,Construction,Private sector building sites,29556,27185,2371,2,490
All,2006 Q4,F,Construction,Private sector civil engineering sites,1434,1371,63,0,91
All,2006 Q4,G,"Import/export, wholesale and retail trades",Import and export trade,518073,265088,252985,6165,99287
All,2006 Q4,G,"Import/export, wholesale and retail trades",Wholesale,66578,40870,25708,619,14857
All,2006 Q4,G,"Import/export, wholesale and retail trades",Retail trade,226441,94574,131867,4106,56431
All,2006 Q4,H,"Transportation, storage, postal and courier services",Land transport,43035,37352,5683,314,2623
All,2006 Q4,H,"Transportation, storage, postal and courier services",Water transport,8405,5252,3153,88,292
All,2006 Q4,H,"Transportation, storage, postal and courier services",Air transport,18903,7416,11487,90,113
All,2006 Q4,H,"Transportation, storage, postal and courier services",Warehousing and support services for transportation,66349,41172,25177,727,4391
All,2006 Q4,H,"Transportation, storage, postal and courier services",Postal and courier services,12170,8625,3545,267,602
All,2006 Q4,I,Accommodation and food services,Accommodation services,30506,16907,13599,506,778
All,2006 Q4,I,Accommodation and food services,Food and beverage services,203173,94842,108331,3289,12647
All,2006 Q4,J,Information and communications,Publishing,21036,11867,9169,262,1419
All,2006 Q4,J,Information and communications,"Motion picture, video and television programme production, sound recording and music publishing; Programming and broadcasting",14010,8643,5367,354,1634
All,2006 Q4,J,Information and communications,Telecommunications,14726,9377,5349,349,281
All,2006 Q4,J,Information and communications,Information technology services,31441,23551,7890,750,5041
All,2006 Q4,J,Information and communications,Information services,2612,1514,1098,72,474
All,2006 Q4,K,Financing and insurance,Financial services (except insurance and pension funding),109667,50369,59298,2142,5599
All,2006 Q4,K,Financing and insurance,Insurance,11461,4367,7094,112,110
All,2006 Q4,K,Financing and insurance,Services auxiliary to financial and insurance services,46571,22351,24220,1349,10188
All,2006 Q4,L,Real estate,Real estate,99586,66774,32812,2476,10338
All,2006 Q4,M,"Professional, scientific and technical services",Legal and accounting services,42173,17535,24638,547,5623
All,2006 Q4,M,"Professional, scientific and technical services",Activities of head offices; management and management consultancy services,25945,12806,13139,457,4418
All,2006 Q4,M,"Professional, scientific and technical services","Architecture and engineering services, technical testing and analysis",28355,19323,9032,444,2495
All,2006 Q4,M,"Professional, scientific and technical services",Scientific research and development,721,455,266,215,38
All,2006 Q4,M,"Professional, scientific and technical services",Advertising and market research,14235,8035,6200,362,3367
All,2006 Q4,M,"Professional, scientific and technical services","Veterinary services; Other professional, scientific and technical services",16551,9237,7314,367,5082
All,2006 Q4,N,Administrative and support services,Rental and leasing services,1581,945,636,24,442
All,2006 Q4,N,Administrative and support services,Employment services,10331,4045,6286,290,1830
All,2006 Q4,N,Administrative and support services,"Travel agency, reservation service and related services",21043,9221,11822,514,2282
All,2006 Q4,N,Administrative and support services,Security and investigation services,39076,30190,8886,935,193
All,2006 Q4,N,Administrative and support services,Services to buildings and landscape care,58214,20582,37632,378,1233
All,2006 Q4,N,Administrative and support services,"Office administrative, office support and other business support services",19866,9634,10232,374,4006
All,2006 Q4,P,Education,Education,143918,52041,91877,1803,6424
All,2006 Q4,Q,Human health and social work services,Human health services,79019,21850,57169,1014,5625
All,2006 Q4,Q,Human health and social work services,Residential care services,26160,3326,22834,796,1090
All,2006 Q4,Q,Human health and social work services,Social work services,27476,6532,20944,933,1809
All,2006 Q4,R,"Arts, entertainment and recreation",Creative and performing arts activities,2504,1320,1184,70,607
All,2006 Q4,R,"Arts, entertainment and recreation","Libraries, archives, museums and other cultural activities",430,142,288,20,75
All,2006 Q4,R,"Arts, entertainment and recreation",Amusement parks and theme parks,5607,2991,2616,222,6
All,2006 Q4,R,"Arts, entertainment and recreation",Sports and other entertainment services,32450,17001,15449,1349,866
All,2006 Q4,S,Other services,Activities of membership organisations,9243,3987,5256,212,931
All,2006 Q4,S,Other services,"Repair of motor vehicles, motorcycles, computers, personal and household goods",15361,12974,2387,262,4979
All,2006 Q4,S,Other services,Other personal services,39351,13434,25917,1529,9250
All,2007 Q1,C,Manufacturing,Manufacture of food products,23261,12691,10570,251,755
All,2007 Q1,C,Manufacturing,Manufacture of beverages,3548,2547,1001,49,23
All,2007 Q1,C,Manufacturing,Manufacture of tobacco products,462,321,141,11,3
All,2007 Q1,C,Manufacturing,Manufacture of textiles,10613,5712,4901,90,888
All,2007 Q1,C,Manufacturing,Manufacture of wearing apparel,25777,6596,19181,343,1640
All,2007 Q1,C,Manufacturing,"Manufacture of leather and related products; Manufacture of wood and of products of wood and cork, articles of straw and plaiting materials (except furniture and toys)",432,359,73,0,152
All,2007 Q1,C,Manufacturing,Manufacture of paper and paper products,1882,1256,626,17,413
All,2007 Q1,C,Manufacturing,Printing and reproduction of recorded media,21504,14187,7317,194,3145
All,2007 Q1,C,Manufacturing,Manufacture of coke and refined petroleum products; Manufacture of chemicals and chemical products,2371,1697,674,18,227
All,2007 Q1,C,Manufacturing,"Manufacture of pharmaceuticals, medicinal chemical and botanical products",3021,1303,1718,57,222
All,2007 Q1,C,Manufacturing,"Manufacture of rubber and plastics products (except furniture, toys, sports goods and stationery)",2754,1912,842,21,491
All,2007 Q1,C,Manufacturing,Manufacture of other non-metallic mineral products,1228,1043,185,27,211
All,2007 Q1,C,Manufacturing,Manufacture of basic metals,1201,968,233,16,74
All,2007 Q1,C,Manufacturing,Manufacture of fabricated metal products (except machinery and equipment),4986,3400,1586,48,1103
All,2007 Q1,C,Manufacturing,"Manufacture of computer, electronic and optical products",9141,5141,4000,277,392
All,2007 Q1,C,Manufacturing,Manufacture of electrical equipment,2584,1630,954,71,281
All,2007 Q1,C,Manufacturing,Manufacture of machinery and equipment n.e.c.,2356,2002,354,18,664
All,2007 Q1,C,Manufacturing,Body assembly of motor vehicles; Manufacture of other transport equipment,1644,1288,356,38,87
All,2007 Q1,C,Manufacturing,Manufacture of furniture,448,377,71,3,165
All,2007 Q1,C,Manufacturing,Other manufacturing,8759,5380,3379,130,1501
All,2007 Q1,C,Manufacturing,Repair and installation of machinery and equipment,11289,9660,1629,329,1297
All,2007 Q1,B,Mining and quarrying,Quarrying and other mining of non-metal ores,124,119,5,0,6
All,2007 Q1,D,Electricity and gas supply,Electricity and gas supply,7914,6717,1197,3,16
All,2007 Q1,E,"Sewerage, waste management and remediation services",Sewerage,502,298,204,0,37
All,2007 Q1,E,"Sewerage, waste management and remediation services","Waste collection, treatment and disposal; materials recovery",1428,873,555,14,182
All,2007 Q1,E,"Sewerage, waste management and remediation services",Remediation and other waste management services,16,15,1,0,16
All,2007 Q1,F,Construction,Construction sites (manual workers only),50366,47084,3282,38,903
All,2007 Q1,F,Construction,Public sector sites,20569,19470,1099,28,348
All,2007 Q1,F,Construction,Public sector building sites,8394,7790,604,26,100
All,2007 Q1,F,Construction,Public sector civil engineering sites,12175,11680,495,2,248
All,2007 Q1,F,Construction,Private sector sites,29797,27614,2183,10,555
All,2007 Q1,F,Construction,Private sector building sites,28123,25992,2131,10,454
All,2007 Q1,F,Construction,Private sector civil engineering sites,1674,1622,52,0,101
All,2007 Q1,G,"Import/export, wholesale and retail trades",Import and export trade,519591,265679,253912,9289,99085
All,2007 Q1,G,"Import/export, wholesale and retail trades",Wholesale,66021,40755,25266,1065,14730
All,2007 Q1,G,"Import/export, wholesale and retail trades",Retail trade,225934,94447,131487,4999,56452
All,2007 Q1,H,"Transportation, storage, postal and courier services",Land transport,42682,37099,5583,306,2504
All,2007 Q1,H,"Transportation, storage, postal and courier services",Water transport,8522,5388,3134,84,291
All,2007 Q1,H,"Transportation, storage, postal and courier services",Air transport,19140,7446,11694,91,112
All,2007 Q1,H,"Transportation, storage, postal and courier services",Warehousing and support services for transportation,65398,40919,24479,1037,4407
All,2007 Q1,H,"Transportation, storage, postal and courier services",Postal and courier services,12322,8450,3872,296,631
All,2007 Q1,I,Accommodation and food services,Accommodation services,30467,16900,13567,690,817
All,2007 Q1,I,Accommodation and food services,Food and beverage services,203560,94310,109250,3636,12785
All,2007 Q1,J,Information and communications,Publishing,21421,11780,9641,428,1483
All,2007 Q1,J,Information and communications,"Motion picture, video and television programme production, sound recording and music publishing; Programming and broadcasting",14106,8911,5195,250,1563
All,2007 Q1,J,Information and communications,Telecommunications,15862,10047,5815,290,270
All,2007 Q1,J,Information and communications,Information technology services,31223,23516,7707,1149,4916
All,2007 Q1,J,Information and communications,Information services,2354,1482,872,79,402
All,2007 Q1,K,Financing and insurance,Financial services (except insurance and pension funding),110486,51342,59144,2579,5518
All,2007 Q1,K,Financing and insurance,Insurance,11242,4267,6975,173,132
All,2007 Q1,K,Financing and insurance,Services auxiliary to financial and insurance services,46048,22221,23827,2283,10031
All,2007 Q1,L,Real estate,Real estate,100283,67365,32918,3727,10486
All,2007 Q1,M,"Professional, scientific and technical services",Legal and accounting services,41063,17657,23406,802,5623
All,2007 Q1,M,"Professional, scientific and technical services",Activities of head offices; management and management consultancy services,27366,14787,12579,639,4457
All,2007 Q1,M,"Professional, scientific and technical services","Architecture and engineering services, technical testing and analysis",27005,18089,8916,482,2550
All,2007 Q1,M,"Professional, scientific and technical services",Scientific research and development,731,476,255,29,39
All,2007 Q1,M,"Professional, scientific and technical services",Advertising and market research,14178,7900,6278,559,3403
All,2007 Q1,M,"Professional, scientific and technical services","Veterinary services; Other professional, scientific and technical services",16652,9357,7295,597,5177
All,2007 Q1,N,Administrative and support services,Rental and leasing services,1995,1185,810,30,580
All,2007 Q1,N,Administrative and support services,Employment services,10552,3829,6723,309,1779
All,2007 Q1,N,Administrative and support services,"Travel agency, reservation service and related services",20300,7738,12562,674,2266
All,2007 Q1,N,Administrative and support services,Security and investigation services,37787,28895,8892,680,162
All,2007 Q1,N,Administrative and support services,Services to buildings and landscape care,59128,19611,39517,448,1267
All,2007 Q1,N,Administrative and support services,"Office administrative, office support and other business support services",20688,9781,10907,805,4093
All,2007 Q1,P,Education,Education,144033,53659,90374,2093,6591
All,2007 Q1,Q,Human health and social work services,Human health services,81167,22477,58690,1678,5761
All,2007 Q1,Q,Human health and social work services,Residential care services,28659,3728,24931,1026,1146
All,2007 Q1,Q,Human health and social work services,Social work services,26093,5731,20362,587,1727
All,2007 Q1,R,"Arts, entertainment and recreation",Creative and performing arts activities,2427,1473,954,74,700
All,2007 Q1,R,"Arts, entertainment and recreation","Libraries, archives, museums and other cultural activities",437,153,284,6,69
All,2007 Q1,R,"Arts, entertainment and recreation",Amusement parks and theme parks,5480,2949,2531,214,6
All,2007 Q1,R,"Arts, entertainment and recreation",Sports and other entertainment services,32548,17200,15348,837,858
All,2007 Q1,S,Other services,Activities of membership organisations,9211,4133,5078,161,937
All,2007 Q1,S,Other services,"Repair of motor vehicles, motorcycles, computers, personal and household goods",15654,12920,2734,233,4896
All,2007 Q1,S,Other services,Other personal services,38385,12866,25519,1851,9292
All,2007 Q2,C,Manufacturing,Manufacture of food products,22244,12605,9639,350,731
All,2007 Q2,C,Manufacturing,Manufacture of beverages,3605,2573,1032,65,28
All,2007 Q2,C,Manufacturing,Manufacture of tobacco products,430,295,135,0,2
All,2007 Q2,C,Manufacturing,Manufacture of textiles,9792,5464,4328,41,872
All,2007 Q2,C,Manufacturing,Manufacture of wearing apparel,25551,6289,19262,236,1644
All,2007 Q2,C,Manufacturing,"Manufacture of leather and related products; Manufacture of wood and of products of wood and cork, articles of straw and plaiting materials (except furniture and toys)",341,258,83,0,139
All,2007 Q2,C,Manufacturing,Manufacture of paper and paper products,1704,1178,526,10,395
All,2007 Q2,C,Manufacturing,Printing and reproduction of recorded media,20829,13978,6851,191,3070
All,2007 Q2,C,Manufacturing,Manufacture of coke and refined petroleum products; Manufacture of chemicals and chemical products,2494,1648,846,9,211
All,2007 Q2,C,Manufacturing,"Manufacture of pharmaceuticals, medicinal chemical and botanical products",3211,1362,1849,63,231
All,2007 Q2,C,Manufacturing,"Manufacture of rubber and plastics products (except furniture, toys, sports goods and stationery)",2950,1925,1025,33,483
All,2007 Q2,C,Manufacturing,Manufacture of other non-metallic mineral products,1031,851,180,0,208
All,2007 Q2,C,Manufacturing,Manufacture of basic metals,1193,964,229,14,72
All,2007 Q2,C,Manufacturing,Manufacture of fabricated metal products (except machinery and equipment),4601,3711,890,47,1056
All,2007 Q2,C,Manufacturing,"Manufacture of computer, electronic and optical products",9816,5477,4339,142,407
All,2007 Q2,C,Manufacturing,Manufacture of electrical equipment,2661,1573,1088,78,254
All,2007 Q2,C,Manufacturing,Manufacture of machinery and equipment n.e.c.,3075,2643,432,25,763
All,2007 Q2,C,Manufacturing,Body assembly of motor vehicles; Manufacture of other transport equipment,1652,1323,329,28,82
All,2007 Q2,C,Manufacturing,Manufacture of furniture,646,552,94,2,151
All,2007 Q2,C,Manufacturing,Other manufacturing,8902,5387,3515,88,1478
All,2007 Q2,C,Manufacturing,Repair and installation of machinery and equipment,11335,9380,1955,338,1113
All,2007 Q2,B,Mining and quarrying,Quarrying and other mining of non-metal ores,125,119,6,0,6
All,2007 Q2,D,Electricity and gas supply,Electricity and gas supply,7902,6690,1212,4,16
All,2007 Q2,E,"Sewerage, waste management and remediation services",Sewerage,123,35,88,0,39
All,2007 Q2,E,"Sewerage, waste management and remediation services","Waste collection, treatment and disposal; materials recovery",1748,1259,489,26,195
All,2007 Q2,E,"Sewerage, waste management and remediation services",Remediation and other waste management services,64,24,40,0,16
All,2007 Q2,F,Construction,Construction sites (manual workers only),51098,47284,3814,16,929
All,2007 Q2,F,Construction,Public sector sites,19232,18180,1052,15,336
All,2007 Q2,F,Construction,Public sector building sites,7567,7013,554,13,96
All,2007 Q2,F,Construction,Public sector civil engineering sites,11665,11167,498,2,240
All,2007 Q2,F,Construction,Private sector sites,31866,29104,2762,1,593
All,2007 Q2,F,Construction,Private sector building sites,30100,27413,2687,1,477
All,2007 Q2,F,Construction,Private sector civil engineering sites,1766,1691,75,0,116
All,2007 Q2,G,"Import/export, wholesale and retail trades",Import and export trade,518870,266967,251903,8004,99089
All,2007 Q2,G,"Import/export, wholesale and retail trades",Wholesale,67419,41300,26119,1023,14682
All,2007 Q2,G,"Import/export, wholesale and retail trades",Retail trade,229738,95444,134294,4133,56693
All,2007 Q2,H,"Transportation, storage, postal and courier services",Land transport,42928,37044,5884,268,2492
All,2007 Q2,H,"Transportation, storage, postal and courier services",Water transport,8747,5685,3062,87,286
All,2007 Q2,H,"Transportation, storage, postal and courier services",Air transport,19578,7718,11860,127,112
All,2007 Q2,H,"Transportation, storage, postal and courier services",Warehousing and support services for transportation,68394,42404,25990,1131,4491
All,2007 Q2,H,"Transportation, storage, postal and courier services",Postal and courier services,12571,8487,4084,324,614
All,2007 Q2,I,Accommodation and food services,Accommodation services,30834,17182,13652,666,828
All,2007 Q2,I,Accommodation and food services,Food and beverage services,202468,96065,106403,3895,12718
All,2007 Q2,J,Information and communications,Publishing,20635,11687,8948,243,1460
All,2007 Q2,J,Information and communications,"Motion picture, video and television programme production, sound recording and music publishing; Programming and broadcasting",14163,8893,5270,82,1692
All,2007 Q2,J,Information and communications,Telecommunications,15711,9884,5827,353,283
All,2007 Q2,J,Information and communications,Information technology services,32294,24217,8077,1138,5028
All,2007 Q2,J,Information and communications,Information services,2487,1422,1065,82,390
All,2007 Q2,K,Financing and insurance,Financial services (except insurance and pension funding),113868,53387,60481,2580,5467
All,2007 Q2,K,Financing and insurance,Insurance,12000,4559,7441,322,122
All,2007 Q2,K,Financing and insurance,Services auxiliary to financial and insurance services,47099,22678,24421,2311,9983
All,2007 Q2,L,Real estate,Real estate,103265,69182,34083,3031,10711
All,2007 Q2,M,"Professional, scientific and technical services",Legal and accounting services,41586,18596,22990,615,5682
All,2007 Q2,M,"Professional, scientific and technical services",Activities of head offices; management and management consultancy services,28708,14318,14390,907,4552
All,2007 Q2,M,"Professional, scientific and technical services","Architecture and engineering services, technical testing and analysis",28852,19333,9519,502,2627
All,2007 Q2,M,"Professional, scientific and technical services",Scientific research and development,694,479,215,108,34
All,2007 Q2,M,"Professional, scientific and technical services",Advertising and market research,14315,7774,6541,297,3389
All,2007 Q2,M,"Professional, scientific and technical services","Veterinary services; Other professional, scientific and technical services",16580,9403,7177,570,5254
All,2007 Q2,N,Administrative and support services,Rental and leasing services,1729,938,791,16,532
All,2007 Q2,N,Administrative and support services,Employment services,9226,3681,5545,201,1705
All,2007 Q2,N,Administrative and support services,"Travel agency, reservation service and related services",20551,8213,12338,590,2248
All,2007 Q2,N,Administrative and support services,Security and investigation services,37105,28538,8567,838,129
All,2007 Q2,N,Administrative and support services,Services to buildings and landscape care,59931,20514,39417,538,1321
All,2007 Q2,N,Administrative and support services,"Office administrative, office support and other business support services",21734,10582,11152,504,4186
All,2007 Q2,P,Education,Education,145447,52960,92487,2293,6674
All,2007 Q2,Q,Human health and social work services,Human health services,82472,22978,59494,1583,5771
All,2007 Q2,Q,Human health and social work services,Residential care services,25609,3374,22235,975,1052
All,2007 Q2,Q,Human health and social work services,Social work services,28253,6956,21297,565,1809
All,2007 Q2,R,"Arts, entertainment and recreation",Creative and performing arts activities,2291,1295,996,77,561
All,2007 Q2,R,"Arts, entertainment and recreation","Libraries, archives, museums and other cultural activities",416,131,285,7,73
All,2007 Q2,R,"Arts, entertainment and recreation",Amusement parks and theme parks,4864,2643,2221,302,5
All,2007 Q2,R,"Arts, entertainment and recreation",Sports and other entertainment services,34428,18287,16141,769,878
All,2007 Q2,S,Other services,Activities of membership organisations,9176,3797,5379,180,944
All,2007 Q2,S,Other services,"Repair of motor vehicles, motorcycles, computers, personal and household goods",16193,13178,3015,262,5177
All,2007 Q2,S,Other services,Other personal services,38560,12843,25717,1542,9101
All,2007 Q3,C,Manufacturing,Manufacture of food products,23061,12437,10624,374,767
All,2007 Q3,C,Manufacturing,Manufacture of beverages,3645,2606,1039,71,23
All,2007 Q3,C,Manufacturing,Manufacture of tobacco products,427,294,133,0,2
All,2007 Q3,C,Manufacturing,Manufacture of textiles,9791,5192,4599,87,886
All,2007 Q3,C,Manufacturing,Manufacture of wearing apparel,24233,6992,17241,201,1616
All,2007 Q3,C,Manufacturing,"Manufacture of leather and related products; Manufacture of wood and of products of wood and cork, articles of straw and plaiting materials (except furniture and toys)",554,394,160,0,169
All,2007 Q3,C,Manufacturing,Manufacture of paper and paper products,1746,1177,569,14,424
All,2007 Q3,C,Manufacturing,Printing and reproduction of recorded media,20284,13909,6375,230,3074
All,2007 Q3,C,Manufacturing,Manufacture of coke and refined petroleum products; Manufacture of chemicals and chemical products,2304,1572,732,51,197
All,2007 Q3,C,Manufacturing,"Manufacture of pharmaceuticals, medicinal chemical and botanical products",3044,1214,1830,161,236
All,2007 Q3,C,Manufacturing,"Manufacture of rubber and plastics products (except furniture, toys, sports goods and stationery)",2687,1768,919,5,483
All,2007 Q3,C,Manufacturing,Manufacture of other non-metallic mineral products,1055,845,210,0,209
All,2007 Q3,C,Manufacturing,Manufacture of basic metals,1105,903,202,19,81
All,2007 Q3,C,Manufacturing,Manufacture of fabricated metal products (except machinery and equipment),4152,2929,1223,5,1022
All,2007 Q3,C,Manufacturing,"Manufacture of computer, electronic and optical products",9801,5710,4091,118,386
All,2007 Q3,C,Manufacturing,Manufacture of electrical equipment,2224,1386,838,82,231
All,2007 Q3,C,Manufacturing,Manufacture of machinery and equipment n.e.c.,2533,2082,451,18,622
All,2007 Q3,C,Manufacturing,Body assembly of motor vehicles; Manufacture of other transport equipment,1584,1312,272,9,105
All,2007 Q3,C,Manufacturing,Manufacture of furniture,640,550,90,0,158
All,2007 Q3,C,Manufacturing,Other manufacturing,9428,5470,3958,80,1537
All,2007 Q3,C,Manufacturing,Repair and installation of machinery and equipment,12108,10212,1896,233,1346
All,2007 Q3,B,Mining and quarrying,Quarrying and other mining of non-metal ores,105,101,4,0,5
All,2007 Q3,D,Electricity and gas supply,Electricity and gas supply,7929,6715,1214,3,17
All,2007 Q3,E,"Sewerage, waste management and remediation services",Sewerage,187,95,92,0,44
All,2007 Q3,E,"Sewerage, waste management and remediation services","Waste collection, treatment and disposal; materials recovery",1759,1095,664,28,177
All,2007 Q3,E,"Sewerage, waste management and remediation services",Remediation and other waste management services,92,57,35,0,17
All,2007 Q3,F,Construction,Construction sites (manual workers only),49173,45697,3476,26,926
All,2007 Q3,F,Construction,Public sector sites,18762,17741,1021,5,355
All,2007 Q3,F,Construction,Public sector building sites,7117,6559,558,2,107
All,2007 Q3,F,Construction,Public sector civil engineering sites,11645,11182,463,3,248
All,2007 Q3,F,Construction,Private sector sites,30411,27956,2455,21,571
All,2007 Q3,F,Construction,Private sector building sites,29016,26607,2409,21,470
All,2007 Q3,F,Construction,Private sector civil engineering sites,1395,1349,46,0,101
All,2007 Q3,G,"Import/export, wholesale and retail trades",Import and export trade,518843,266436,252407,7463,97862
All,2007 Q3,G,"Import/export, wholesale and retail trades",Wholesale,66097,40961,25136,1326,14979
All,2007 Q3,G,"Import/export, wholesale and retail trades",Retail trade,229479,93055,136424,4972,56477
All,2007 Q3,H,"Transportation, storage, postal and courier services",Land transport,42031,36258,5773,329,2417
All,2007 Q3,H,"Transportation, storage, postal and courier services",Water transport,8602,5304,3298,55,300
All,2007 Q3,H,"Transportation, storage, postal and courier services",Air transport,19848,7823,12025,150,111
All,2007 Q3,H,"Transportation, storage, postal and courier services",Warehousing and support services for transportation,68268,41916,26352,1191,4571
All,2007 Q3,H,"Transportation, storage, postal and courier services",Postal and courier services,12350,8544,3806,411,659
All,2007 Q3,I,Accommodation and food services,Accommodation services,31217,17313,13904,816,807
All,2007 Q3,I,Accommodation and food services,Food and beverage services,207948,97933,110015,5882,12899
All,2007 Q3,J,Information and communications,Publishing,21185,11837,9348,420,1497
All,2007 Q3,J,Information and communications,"Motion picture, video and television programme production, sound recording and music publishing; Programming and broadcasting",14697,9250,5447,291,1607
All,2007 Q3,J,Information and communications,Telecommunications,14986,9545,5441,415,280
All,2007 Q3,J,Information and communications,Information technology services,31509,23546,7963,1063,4968
All,2007 Q3,J,Information and communications,Information services,3083,1689,1394,105,477
All,2007 Q3,K,Financing and insurance,Financial services (except insurance and pension funding),115121,54601,60520,2859,5444
All,2007 Q3,K,Financing and insurance,Insurance,12075,4591,7484,315,143
All,2007 Q3,K,Financing and insurance,Services auxiliary to financial and insurance services,49263,23920,25343,2044,10066
All,2007 Q3,L,Real estate,Real estate,103238,68925,34313,3204,10749
All,2007 Q3,M,"Professional, scientific and technical services",Legal and accounting services,43026,19885,23141,857,5728
All,2007 Q3,M,"Professional, scientific and technical services",Activities of head offices; management and management consultancy services,27765,14091,13674,665,4642
All,2007 Q3,M,"Professional, scientific and technical services","Architecture and engineering services, technical testing and analysis",29101,19514,9587,813,2626
All,2007 Q3,M,"Professional, scientific and technical services",Scientific research and development,741,488,253,104,32
All,2007 Q3,M,"Professional, scientific and technical services",Advertising and market research,15274,8230,7044,359,3373
All,2007 Q3,M,"Professional, scientific and technical services","Veterinary services; Other professional, scientific and technical services",17301,9910,7391,537,5316
All,2007 Q3,N,Administrative and support services,Rental and leasing services,1912,967,945,51,626
All,2007 Q3,N,Administrative and support services,Employment services,10214,3842,6372,543,1741
All,2007 Q3,N,Administrative and support services,"Travel agency, reservation service and related services",21662,8889,12773,618,2221
All,2007 Q3,N,Administrative and support services,Security and investigation services,37358,28306,9052,979,148
All,2007 Q3,N,Administrative and support services,Services to buildings and landscape care,56183,19836,36347,557,1344
All,2007 Q3,N,Administrative and support services,"Office administrative, office support and other business support services",20788,10640,10148,768,4134
All,2007 Q3,P,Education,Education,144863,53690,91173,2808,6709
All,2007 Q3,Q,Human health and social work services,Human health services,82776,22602,60174,1300,5717
All,2007 Q3,Q,Human health and social work services,Residential care services,27436,4141,23295,1099,1176
All,2007 Q3,Q,Human health and social work services,Social work services,26272,5174,21098,909,1684
All,2007 Q3,R,"Arts, entertainment and recreation",Creative and performing arts activities,2284,1194,1090,50,613
All,2007 Q3,R,"Arts, entertainment and recreation","Libraries, archives, museums and other cultural activities",409,120,289,8,72
All,2007 Q3,R,"Arts, entertainment and recreation",Amusement parks and theme parks,4825,2599,2226,198,5
All,2007 Q3,R,"Arts, entertainment and recreation",Sports and other entertainment services,32900,17326,15574,1717,964
All,2007 Q3,S,Other services,Activities of membership organisations,9242,3726,5516,221,929
All,2007 Q3,S,Other services,"Repair of motor vehicles, motorcycles, computers, personal and household goods",15982,12920,3062,328,5087
All,2007 Q3,S,Other services,Other personal services,40650,14064,26586,1656,9293
All,2007 Q4,C,Manufacturing,Manufacture of food products,22777,12070,10707,393,767
All,2007 Q4,C,Manufacturing,Manufacture of beverages,3735,2645,1090,65,30
All,2007 Q4,C,Manufacturing,Manufacture of tobacco products,426,293,133,0,2
All,2007 Q4,C,Manufacturing,Manufacture of textiles,9381,4909,4472,53,891
All,2007 Q4,C,Manufacturing,Manufacture of wearing apparel,23721,6599,17122,161,1567
All,2007 Q4,C,Manufacturing,"Manufacture of leather and related products; Manufacture of wood and of products of wood and cork, articles of straw and plaiting materials (except furniture and toys)",490,414,76,0,186
All,2007 Q4,C,Manufacturing,Manufacture of paper and paper products,1815,1236,579,12,405
All,2007 Q4,C,Manufacturing,Printing and reproduction of recorded media,21282,14531,6751,208,3125
All,2007 Q4,C,Manufacturing,Manufacture of coke and refined petroleum products; Manufacture of chemicals and chemical products,2255,1550,705,19,199
All,2007 Q4,C,Manufacturing,"Manufacture of pharmaceuticals, medicinal chemical and botanical products",2964,1198,1766,53,245
All,2007 Q4,C,Manufacturing,"Manufacture of rubber and plastics products (except furniture, toys, sports goods and stationery)",2578,1762,816,14,476
All,2007 Q4,C,Manufacturing,Manufacture of other non-metallic mineral products,966,773,193,0,181
All,2007 Q4,C,Manufacturing,Manufacture of basic metals,1126,934,192,24,88
All,2007 Q4,C,Manufacturing,Manufacture of fabricated metal products (except machinery and equipment),4463,3373,1090,13,1061
All,2007 Q4,C,Manufacturing,"Manufacture of computer, electronic and optical products",10043,5856,4187,164,416
All,2007 Q4,C,Manufacturing,Manufacture of electrical equipment,2355,1385,970,20,240
All,2007 Q4,C,Manufacturing,Manufacture of machinery and equipment n.e.c.,2157,1808,349,46,634
All,2007 Q4,C,Manufacturing,Body assembly of motor vehicles; Manufacture of other transport equipment,1465,1120,345,25,94
All,2007 Q4,C,Manufacturing,Manufacture of furniture,602,519,83,12,153
All,2007 Q4,C,Manufacturing,Other manufacturing,8722,5072,3650,98,1439
All,2007 Q4,C,Manufacturing,Repair and installation of machinery and equipment,12386,10697,1689,257,1244
All,2007 Q4,B,Mining and quarrying,Quarrying and other mining of non-metal ores,102,98,4,0,5
All,2007 Q4,D,Electricity and gas supply,Electricity and gas supply,7895,6678,1217,28,19
All,2007 Q4,E,"Sewerage, waste management and remediation services",Sewerage,576,317,259,0,51
All,2007 Q4,E,"Sewerage, waste management and remediation services","Waste collection, treatment and disposal; materials recovery",1664,1157,507,36,192
All,2007 Q4,E,"Sewerage, waste management and remediation services",Remediation and other waste management services,70,70,0,0,10
All,2007 Q4,F,Construction,Construction sites (manual workers only),50103,46273,3830,15,946
All,2007 Q4,F,Construction,Public sector sites,18521,17404,1117,2,350
All,2007 Q4,F,Construction,Public sector building sites,7990,7303,687,0,118
All,2007 Q4,F,Construction,Public sector civil engineering sites,10531,10101,430,2,232
All,2007 Q4,F,Construction,Private sector sites,31582,28869,2713,13,596
All,2007 Q4,F,Construction,Private sector building sites,29722,27074,2648,13,498
All,2007 Q4,F,Construction,Private sector civil engineering sites,1860,1795,65,0,98
All,2007 Q4,G,"Import/export, wholesale and retail trades",Import and export trade,520227,266788,253439,7361,96539
All,2007 Q4,G,"Import/export, wholesale and retail trades",Wholesale,66690,40800,25890,925,14726
All,2007 Q4,G,"Import/export, wholesale and retail trades",Retail trade,233472,95508,137964,4390,56680
All,2007 Q4,H,"Transportation, storage, postal and courier services",Land transport,42495,36883,5612,350,2437
All,2007 Q4,H,"Transportation, storage, postal and courier services",Water transport,9266,5450,3816,96,301
All,2007 Q4,H,"Transportation, storage, postal and courier services",Air transport,20306,7930,12376,132,112
All,2007 Q4,H,"Transportation, storage, postal and courier services",Warehousing and support services for transportation,68753,43022,25731,1023,4607
All,2007 Q4,H,"Transportation, storage, postal and courier services",Postal and courier services,12216,8275,3941,191,650
All,2007 Q4,I,Accommodation and food services,Accommodation services,31724,17402,14322,506,817
All,2007 Q4,I,Accommodation and food services,Food and beverage services,208936,96808,112128,4886,12883
All,2007 Q4,J,Information and communications,Publishing,21518,12007,9511,312,1534
All,2007 Q4,J,Information and communications,"Motion picture, video and television programme production, sound recording and music publishing; Programming and broadcasting",14733,9304,5429,242,1516
All,2007 Q4,J,Information and communications,Telecommunications,15025,9804,5221,363,266
All,2007 Q4,J,Information and communications,Information technology services,32138,24706,7432,828,4926
All,2007 Q4,J,Information and communications,Information services,2851,1351,1500,133,398
All,2007 Q4,K,Financing and insurance,Financial services (except insurance and pension funding),118564,55424,63140,2279,5586
All,2007 Q4,K,Financing and insurance,Insurance,12352,4688,7664,262,130
All,2007 Q4,K,Financing and insurance,Services auxiliary to financial and insurance services,48735,23951,24784,1973,9989
All,2007 Q4,L,Real estate,Real estate,105063,68996,36067,2943,10828
All,2007 Q4,M,"Professional, scientific and technical services",Legal and accounting services,43816,18941,24875,603,5851
All,2007 Q4,M,"Professional, scientific and technical services",Activities of head offices; management and management consultancy services,27021,12818,14203,425,4663
All,2007 Q4,M,"Professional, scientific and technical services","Architecture and engineering services, technical testing and analysis",28972,19722,9250,782,2638
All,2007 Q4,M,"Professional, scientific and technical services",Scientific research and development,720,430,290,113,42
All,2007 Q4,M,"Professional, scientific and technical services",Advertising and market research,13657,7520,6137,293,3343
All,2007 Q4,M,"Professional, scientific and technical services","Veterinary services; Other professional, scientific and technical services",18678,10482,8196,598,5247
All,2007 Q4,N,Administrative and support services,Rental and leasing services,1973,1199,774,27,529
All,2007 Q4,N,Administrative and support services,Employment services,11947,4785,7162,253,1734
All,2007 Q4,N,Administrative and support services,"Travel agency, reservation service and related services",21379,8695,12684,609,2262
All,2007 Q4,N,Administrative and support services,Security and investigation services,37401,28076,9325,1101,145
All,2007 Q4,N,Administrative and support services,Services to buildings and landscape care,55769,19018,36751,779,1284
All,2007 Q4,N,Administrative and support services,"Office administrative, office support and other business support services",22195,10994,11201,893,4316
All,2007 Q4,P,Education,Education,146439,55254,91185,2146,6756
All,2007 Q4,Q,Human health and social work services,Human health services,84065,22534,61531,1325,5872
All,2007 Q4,Q,Human health and social work services,Residential care services,26834,4017,22817,1103,1172
All,2007 Q4,Q,Human health and social work services,Social work services,27369,6176,21193,837,1681
All,2007 Q4,R,"Arts, entertainment and recreation",Creative and performing arts activities,2200,1142,1058,34,646
All,2007 Q4,R,"Arts, entertainment and recreation","Libraries, archives, museums and other cultural activities",446,155,291,7,72
All,2007 Q4,R,"Arts, entertainment and recreation",Amusement parks and theme parks,4720,2548,2172,151,5
All,2007 Q4,R,"Arts, entertainment and recreation",Sports and other entertainment services,33158,17397,15761,2640,870
All,2007 Q4,S,Other services,Activities of membership organisations,9262,3984,5278,183,941
All,2007 Q4,S,Other services,"Repair of motor vehicles, motorcycles, computers, personal and household goods",15980,12962,3018,261,5203
All,2007 Q4,S,Other services,Other personal services,40735,13650,27085,1982,9379
All,2008 Q1,C,Manufacturing,Manufacture of food products,22555,11863,10692,384,780
All,2008 Q1,C,Manufacturing,Manufacture of beverages,3596,2496,1100,40,27
All,2008 Q1,C,Manufacturing,Manufacture of tobacco products,427,294,133,0,2
All,2008 Q1,C,Manufacturing,Manufacture of textiles,9302,4956,4346,73,851
All,2008 Q1,C,Manufacturing,Manufacture of wearing apparel,22103,6223,15880,186,1551
All,2008 Q1,C,Manufacturing,"Manufacture of leather and related products; Manufacture of wood and of products of wood and cork, articles of straw and plaiting materials (except furniture and toys)",460,357,103,0,160
All,2008 Q1,C,Manufacturing,Manufacture of paper and paper products,1869,1234,635,15,407
All,2008 Q1,C,Manufacturing,Printing and reproduction of recorded media,21380,13808,7572,228,3120
All,2008 Q1,C,Manufacturing,Manufacture of coke and refined petroleum products; Manufacture of chemicals and chemical products,2180,1426,754,17,200
All,2008 Q1,C,Manufacturing,"Manufacture of pharmaceuticals, medicinal chemical and botanical products",3179,1338,1841,42,232
All,2008 Q1,C,Manufacturing,"Manufacture of rubber and plastics products (except furniture, toys, sports goods and stationery)",2786,1774,1012,40,497
All,2008 Q1,C,Manufacturing,Manufacture of other non-metallic mineral products,954,812,142,22,209
All,2008 Q1,C,Manufacturing,Manufacture of basic metals,1191,995,196,9,85
All,2008 Q1,C,Manufacturing,Manufacture of fabricated metal products (except machinery and equipment),4682,3344,1338,60,1028
All,2008 Q1,C,Manufacturing,"Manufacture of computer, electronic and optical products",9800,5597,4203,208,424
All,2008 Q1,C,Manufacturing,Manufacture of electrical equipment,2942,1637,1305,69,268
All,2008 Q1,C,Manufacturing,Manufacture of machinery and equipment n.e.c.,2736,2208,528,31,553
All,2008 Q1,C,Manufacturing,Body assembly of motor vehicles; Manufacture of other transport equipment,1609,1324,285,51,116
All,2008 Q1,C,Manufacturing,Manufacture of furniture,555,436,119,4,140
All,2008 Q1,C,Manufacturing,Other manufacturing,8835,5216,3619,131,1421
All,2008 Q1,C,Manufacturing,Repair and installation of machinery and equipment,12017,10268,1749,396,1183
All,2008 Q1,B,Mining and quarrying,Quarrying and other mining of non-metal ores,98,94,4,0,5
All,2008 Q1,D,Electricity and gas supply,Electricity and gas supply,7842,6646,1196,29,19
All,2008 Q1,E,"Sewerage, waste management and remediation services",Sewerage,410,210,200,0,52
All,2008 Q1,E,"Sewerage, waste management and remediation services","Waste collection, treatment and disposal; materials recovery",2570,1923,647,10,186
All,2008 Q1,E,"Sewerage, waste management and remediation services",Remediation and other waste management services,35,10,25,0,15
All,2008 Q1,F,Construction,Construction sites (manual workers only),50541,47004,3537,38,977
All,2008 Q1,F,Construction,Public sector sites,18965,17805,1160,15,378
All,2008 Q1,F,Construction,Public sector building sites,8491,7755,736,0,124
All,2008 Q1,F,Construction,Public sector civil engineering sites,10474,10050,424,15,254
All,2008 Q1,F,Construction,Private sector sites,31576,29199,2377,23,599
All,2008 Q1,F,Construction,Private sector building sites,29919,27614,2305,23,489
All,2008 Q1,F,Construction,Private sector civil engineering sites,1657,1585,72,0,110
All,2008 Q1,G,"Import/export, wholesale and retail trades",Import and export trade,520748,263911,256837,8935,96832
All,2008 Q1,G,"Import/export, wholesale and retail trades",Wholesale,65439,39313,26126,981,14916
All,2008 Q1,G,"Import/export, wholesale and retail trades",Retail trade,233425,93894,139531,5733,57016
All,2008 Q1,H,"Transportation, storage, postal and courier services",Land transport,41625,36255,5370,226,2547
All,2008 Q1,H,"Transportation, storage, postal and courier services",Water transport,10172,6258,3914,223,311
All,2008 Q1,H,"Transportation, storage, postal and courier services",Air transport,20879,8222,12657,89,111
All,2008 Q1,H,"Transportation, storage, postal and courier services",Warehousing and support services for transportation,70703,44051,26652,1308,4525
All,2008 Q1,H,"Transportation, storage, postal and courier services",Postal and courier services,12164,8065,4099,483,624
All,2008 Q1,I,Accommodation and food services,Accommodation services,31210,17185,14025,763,809
All,2008 Q1,I,Accommodation and food services,Food and beverage services,207036,97388,109648,4627,12812
All,2008 Q1,J,Information and communications,Publishing,20343,11157,9186,383,1334
All,2008 Q1,J,Information and communications,"Motion picture, video and television programme production, sound recording and music publishing; Programming and broadcasting",15790,9668,6122,152,1693
All,2008 Q1,J,Information and communications,Telecommunications,16054,10218,5836,243,267
All,2008 Q1,J,Information and communications,Information technology services,31443,24730,6713,1144,4849
All,2008 Q1,J,Information and communications,Information services,3236,1810,1426,164,426
All,2008 Q1,K,Financing and insurance,Financial services (except insurance and pension funding),119312,56557,62755,2761,5599
All,2008 Q1,K,Financing and insurance,Insurance,13116,5066,8050,345,180
All,2008 Q1,K,Financing and insurance,Services auxiliary to financial and insurance services,50519,24746,25773,2073,10030
All,2008 Q1,L,Real estate,Real estate,105628,69123,36505,3535,10964
All,2008 Q1,M,"Professional, scientific and technical services",Legal and accounting services,44104,19642,24462,1049,5824
All,2008 Q1,M,"Professional, scientific and technical services",Activities of head offices; management and management consultancy services,27224,12677,14547,712,4790
All,2008 Q1,M,"Professional, scientific and technical services","Architecture and engineering services, technical testing and analysis",29449,19591,9858,852,2569
All,2008 Q1,M,"Professional, scientific and technical services",Scientific research and development,795,506,289,120,57
All,2008 Q1,M,"Professional, scientific and technical services",Advertising and market research,14381,8502,5879,487,3259
All,2008 Q1,M,"Professional, scientific and technical services","Veterinary services; Other professional, scientific and technical services",19246,10852,8394,574,5473
All,2008 Q1,N,Administrative and support services,Rental and leasing services,2032,1327,705,35,549
All,2008 Q1,N,Administrative and support services,Employment services,13076,5304,7772,542,2013
All,2008 Q1,N,Administrative and support services,"Travel agency, reservation service and related services",20319,7512,12807,603,2269
All,2008 Q1,N,Administrative and support services,Security and investigation services,38317,28956,9361,1109,201
All,2008 Q1,N,Administrative and support services,Services to buildings and landscape care,56525,18328,38197,894,1274
All,2008 Q1,N,Administrative and support services,"Office administrative, office support and other business support services",19618,9755,9863,618,3846
All,2008 Q1,P,Education,Education,150065,56191,93874,2370,7037
All,2008 Q1,Q,Human health and social work services,Human health services,85947,22542,63405,2346,5873
All,2008 Q1,Q,Human health and social work services,Residential care services,25649,3222,22427,1254,1088
All,2008 Q1,Q,Human health and social work services,Social work services,29228,6851,22377,676,1801
All,2008 Q1,R,"Arts, entertainment and recreation",Creative and performing arts activities,2013,1163,850,18,526
All,2008 Q1,R,"Arts, entertainment and recreation","Libraries, archives, museums and other cultural activities",410,124,286,6,72
All,2008 Q1,R,"Arts, entertainment and recreation",Amusement parks and theme parks,4809,2598,2211,20,5
All,2008 Q1,R,"Arts, entertainment and recreation",Sports and other entertainment services,33985,18210,15775,3158,909
All,2008 Q1,S,Other services,Activities of membership organisations,9182,3831,5351,150,921
All,2008 Q1,S,Other services,"Repair of motor vehicles, motorcycles, computers, personal and household goods",15702,12864,2838,151,5050
All,2008 Q1,S,Other services,Other personal services,39622,13136,26486,2249,9469
All,2008 Q2,C,Manufacturing,Manufacture of food products,22441,12824,9617,392,789
All,2008 Q2,C,Manufacturing,Manufacture of beverages,3600,2673,927,20,31
All,2008 Q2,C,Manufacturing,Manufacture of tobacco products,447,309,138,0,2
All,2008 Q2,C,Manufacturing,Manufacture of textiles,8830,4820,4010,42,855
All,2008 Q2,C,Manufacturing,Manufacture of wearing apparel,22590,6249,16341,82,1476
All,2008 Q2,C,Manufacturing,"Manufacture of leather and related products; Manufacture of wood and of products of wood and cork, articles of straw and plaiting materials (except furniture and toys)",526,370,156,5,167
All,2008 Q2,C,Manufacturing,Manufacture of paper and paper products,1711,1158,553,3,407
All,2008 Q2,C,Manufacturing,Printing and reproduction of recorded media,20030,13574,6456,255,3139
All,2008 Q2,C,Manufacturing,Manufacture of coke and refined petroleum products; Manufacture of chemicals and chemical products,2309,1616,693,32,211
All,2008 Q2,C,Manufacturing,"Manufacture of pharmaceuticals, medicinal chemical and botanical products",3139,1328,1811,194,237
All,2008 Q2,C,Manufacturing,"Manufacture of rubber and plastics products (except furniture, toys, sports goods and stationery)",2758,1780,978,25,482
All,2008 Q2,C,Manufacturing,Manufacture of other non-metallic mineral products,1112,967,145,30,205
All,2008 Q2,C,Manufacturing,Manufacture of basic metals,1204,1038,166,11,91
All,2008 Q2,C,Manufacturing,Manufacture of fabricated metal products (except machinery and equipment),4615,3345,1270,66,1001
All,2008 Q2,C,Manufacturing,"Manufacture of computer, electronic and optical products",9378,5350,4028,155,407
All,2008 Q2,C,Manufacturing,Manufacture of electrical equipment,2273,1349,924,20,267
All,2008 Q2,C,Manufacturing,Manufacture of machinery and equipment n.e.c.,3103,2502,601,66,646
All,2008 Q2,C,Manufacturing,Body assembly of motor vehicles; Manufacture of other transport equipment,1478,1285,193,62,120
All,2008 Q2,C,Manufacturing,Manufacture of furniture,389,325,64,0,133
All,2008 Q2,C,Manufacturing,Other manufacturing,8875,5323,3552,91,1519
All,2008 Q2,C,Manufacturing,Repair and installation of machinery and equipment,12160,10069,2091,423,1142
All,2008 Q2,B,Mining and quarrying,Quarrying and other mining of non-metal ores,102,98,4,0,5
All,2008 Q2,D,Electricity and gas supply,Electricity and gas supply,7799,6605,1194,38,19
All,2008 Q2,E,"Sewerage, waste management and remediation services",Sewerage,247,112,135,5,53
All,2008 Q2,E,"Sewerage, waste management and remediation services","Waste collection, treatment and disposal; materials recovery",2297,1463,834,15,186
All,2008 Q2,E,"Sewerage, waste management and remediation services",Remediation and other waste management services,21,1,20,0,15
All,2008 Q2,F,Construction,Construction sites (manual workers only),49556,45600,3956,30,1014
All,2008 Q2,F,Construction,Public sector sites,18387,17315,1072,28,371
All,2008 Q2,F,Construction,Public sector building sites,7102,6540,562,12,114
All,2008 Q2,F,Construction,Public sector civil engineering sites,11285,10775,510,16,257
All,2008 Q2,F,Construction,Private sector sites,31169,28285,2884,2,643
All,2008 Q2,F,Construction,Private sector building sites,29192,26386,2806,2,535
All,2008 Q2,F,Construction,Private sector civil engineering sites,1977,1899,78,0,108
All,2008 Q2,G,"Import/export, wholesale and retail trades",Import and export trade,520934,263892,257042,8117,97352
All,2008 Q2,G,"Import/export, wholesale and retail trades",Wholesale,64498,39261,25237,853,14796
All,2008 Q2,G,"Import/export, wholesale and retail trades",Retail trade,236058,97414,138644,5188,56768
All,2008 Q2,H,"Transportation, storage, postal and courier services",Land transport,41743,36086,5657,226,2438
All,2008 Q2,H,"Transportation, storage, postal and courier services",Water transport,10364,6291,4073,71,292
All,2008 Q2,H,"Transportation, storage, postal and courier services",Air transport,20507,7806,12701,68,115
All,2008 Q2,H,"Transportation, storage, postal and courier services",Warehousing and support services for transportation,72188,44715,27473,1183,4609
All,2008 Q2,H,"Transportation, storage, postal and courier services",Postal and courier services,12181,7832,4349,395,651
All,2008 Q2,I,Accommodation and food services,Accommodation services,31708,17626,14082,669,843
All,2008 Q2,I,Accommodation and food services,Food and beverage services,210185,96215,113970,4881,12687
All,2008 Q2,J,Information and communications,Publishing,20588,11475,9113,316,1342
All,2008 Q2,J,Information and communications,"Motion picture, video and television programme production, sound recording and music publishing; Programming and broadcasting",16093,10043,6050,262,1813
All,2008 Q2,J,Information and communications,Telecommunications,16488,10427,6061,399,273
All,2008 Q2,J,Information and communications,Information technology services,32919,24497,8422,1257,4740
All,2008 Q2,J,Information and communications,Information services,3721,1982,1739,159,587
All,2008 Q2,K,Financing and insurance,Financial services (except insurance and pension funding),121031,56976,64055,2654,5697
All,2008 Q2,K,Financing and insurance,Insurance,12326,4542,7784,405,125
All,2008 Q2,K,Financing and insurance,Services auxiliary to financial and insurance services,51791,25724,26067,1765,10058
All,2008 Q2,L,Real estate,Real estate,106062,68942,37120,3129,10932
All,2008 Q2,M,"Professional, scientific and technical services",Legal and accounting services,44409,19430,24979,614,5812
All,2008 Q2,M,"Professional, scientific and technical services",Activities of head offices; management and management consultancy services,29046,14064,14982,707,5056
All,2008 Q2,M,"Professional, scientific and technical services","Architecture and engineering services, technical testing and analysis",30145,19902,10243,731,2731
All,2008 Q2,M,"Professional, scientific and technical services",Scientific research and development,866,562,304,83,65
All,2008 Q2,M,"Professional, scientific and technical services",Advertising and market research,14325,7466,6859,328,3193
All,2008 Q2,M,"Professional, scientific and technical services","Veterinary services; Other professional, scientific and technical services",18101,9757,8344,641,5566
All,2008 Q2,N,Administrative and support services,Rental and leasing services,2079,1211,868,28,555
All,2008 Q2,N,Administrative and support services,Employment services,12392,5403,6989,386,1884
All,2008 Q2,N,Administrative and support services,"Travel agency, reservation service and related services",20789,7937,12852,489,2317
All,2008 Q2,N,Administrative and support services,Security and investigation services,39330,29756,9574,1021,206
All,2008 Q2,N,Administrative and support services,Services to buildings and landscape care,57767,19592,38175,880,1250
All,2008 Q2,N,Administrative and support services,"Office administrative, office support and other business support services",18144,8731,9413,468,3762
All,2008 Q2,P,Education,Education,150781,54629,96152,2575,7172
All,2008 Q2,Q,Human health and social work services,Human health services,85843,22864,62979,2476,5858
All,2008 Q2,Q,Human health and social work services,Residential care services,26576,3687,22889,1094,1138
All,2008 Q2,Q,Human health and social work services,Social work services,28608,6519,22089,728,1751
All,2008 Q2,R,"Arts, entertainment and recreation",Creative and performing arts activities,2294,1292,1002,36,475
All,2008 Q2,R,"Arts, entertainment and recreation","Libraries, archives, museums and other cultural activities",407,124,283,7,64
All,2008 Q2,R,"Arts, entertainment and recreation",Amusement parks and theme parks,5201,2821,2380,224,5
All,2008 Q2,R,"Arts, entertainment and recreation",Sports and other entertainment services,34029,17589,16440,1812,864
All,2008 Q2,S,Other services,Activities of membership organisations,8987,3658,5329,216,923
All,2008 Q2,S,Other services,"Repair of motor vehicles, motorcycles, computers, personal and household goods",15813,13107,2706,316,5116
All,2008 Q2,S,Other services,Other personal services,40465,13218,27247,1652,9352
All,2008 Q3,C,Manufacturing,Manufacture of food products,22622,11915,10707,320,781
All,2008 Q3,C,Manufacturing,Manufacture of beverages,3644,2743,901,65,27
All,2008 Q3,C,Manufacturing,Manufacture of tobacco products,458,320,138,0,2
All,2008 Q3,C,Manufacturing,Manufacture of textiles,8076,4287,3789,38,830
All,2008 Q3,C,Manufacturing,Manufacture of wearing apparel,21237,6291,14946,65,1446
All,2008 Q3,C,Manufacturing,"Manufacture of leather and related products; Manufacture of wood and of products of wood and cork, articles of straw and plaiting materials (except furniture and toys)",485,377,108,0,181
All,2008 Q3,C,Manufacturing,Manufacture of paper and paper products,1649,1103,546,21,391
All,2008 Q3,C,Manufacturing,Printing and reproduction of recorded media,19951,13899,6052,115,3117
All,2008 Q3,C,Manufacturing,Manufacture of coke and refined petroleum products; Manufacture of chemicals and chemical products,2487,1696,791,44,248
All,2008 Q3,C,Manufacturing,"Manufacture of pharmaceuticals, medicinal chemical and botanical products",3066,1261,1805,36,225
All,2008 Q3,C,Manufacturing,"Manufacture of rubber and plastics products (except furniture, toys, sports goods and stationery)",2681,1695,986,15,466
All,2008 Q3,C,Manufacturing,Manufacture of other non-metallic mineral products,1004,835,169,22,180
All,2008 Q3,C,Manufacturing,Manufacture of basic metals,1252,1052,200,19,96
All,2008 Q3,C,Manufacturing,Manufacture of fabricated metal products (except machinery and equipment),4597,3297,1300,18,966
All,2008 Q3,C,Manufacturing,"Manufacture of computer, electronic and optical products",9565,5496,4069,98,390
All,2008 Q3,C,Manufacturing,Manufacture of electrical equipment,2551,1560,991,35,284
All,2008 Q3,C,Manufacturing,Manufacture of machinery and equipment n.e.c.,3201,2613,588,38,596
All,2008 Q3,C,Manufacturing,Body assembly of motor vehicles; Manufacture of other transport equipment,1355,1186,169,40,120
All,2008 Q3,C,Manufacturing,Manufacture of furniture,490,344,146,23,140
All,2008 Q3,C,Manufacturing,Other manufacturing,8626,5062,3564,81,1376
All,2008 Q3,C,Manufacturing,Repair and installation of machinery and equipment,12320,10510,1810,397,1275
All,2008 Q3,B,Mining and quarrying,Quarrying and other mining of non-metal ores,98,94,4,0,5
All,2008 Q3,D,Electricity and gas supply,Electricity and gas supply,7794,6625,1169,21,20
All,2008 Q3,E,"Sewerage, waste management and remediation services",Sewerage,302,182,120,5,50
All,2008 Q3,E,"Sewerage, waste management and remediation services","Waste collection, treatment and disposal; materials recovery",2767,1668,1099,49,244
All,2008 Q3,E,"Sewerage, waste management and remediation services",Remediation and other waste management services,26,17,9,0,14
All,2008 Q3,F,Construction,Construction sites (manual workers only),48144,44367,3777,41,1012
All,2008 Q3,F,Construction,Public sector sites,18446,17326,1120,7,378
All,2008 Q3,F,Construction,Public sector building sites,7714,7153,561,0,120
All,2008 Q3,F,Construction,Public sector civil engineering sites,10732,10173,559,7,258
All,2008 Q3,F,Construction,Private sector sites,29698,27041,2657,34,634
All,2008 Q3,F,Construction,Private sector building sites,28305,25691,2614,34,540
All,2008 Q3,F,Construction,Private sector civil engineering sites,1393,1350,43,0,94
All,2008 Q3,G,"Import/export, wholesale and retail trades",Import and export trade,517229,262284,254945,6147,96438
All,2008 Q3,G,"Import/export, wholesale and retail trades",Wholesale,64755,38614,26141,1060,14671
All,2008 Q3,G,"Import/export, wholesale and retail trades",Retail trade,237789,95769,142020,5458,56306
All,2008 Q3,H,"Transportation, storage, postal and courier services",Land transport,41837,36315,5522,379,2431
All,2008 Q3,H,"Transportation, storage, postal and courier services",Water transport,10350,6287,4063,90,298
All,2008 Q3,H,"Transportation, storage, postal and courier services",Air transport,20376,7814,12562,33,116
All,2008 Q3,H,"Transportation, storage, postal and courier services",Warehousing and support services for transportation,72074,45195,26879,922,4581
All,2008 Q3,H,"Transportation, storage, postal and courier services",Postal and courier services,12274,8114,4160,180,651
All,2008 Q3,I,Accommodation and food services,Accommodation services,32718,18022,14696,571,846
All,2008 Q3,I,Accommodation and food services,Food and beverage services,212427,100356,112071,4830,12819
All,2008 Q3,J,Information and communications,Publishing,20299,11121,9178,430,1409
All,2008 Q3,J,Information and communications,"Motion picture, video and television programme production, sound recording and music publishing; Programming and broadcasting",15350,9790,5560,243,1709
All,2008 Q3,J,Information and communications,Telecommunications,16568,10192,6376,405,267
All,2008 Q3,J,Information and communications,Information technology services,33663,25580,8083,896,4888
All,2008 Q3,J,Information and communications,Information services,3983,2121,1862,178,433
All,2008 Q3,K,Financing and insurance,Financial services (except insurance and pension funding),122245,57564,64681,1904,5658
All,2008 Q3,K,Financing and insurance,Insurance,12584,4623,7961,207,177
All,2008 Q3,K,Financing and insurance,Services auxiliary to financial and insurance services,51590,25747,25843,1727,10270
All,2008 Q3,L,Real estate,Real estate,106506,69290,37216,2766,11072
All,2008 Q3,M,"Professional, scientific and technical services",Legal and accounting services,45092,20398,24694,631,5833
All,2008 Q3,M,"Professional, scientific and technical services",Activities of head offices; management and management consultancy services,28349,13448,14901,630,4879
All,2008 Q3,M,"Professional, scientific and technical services","Architecture and engineering services, technical testing and analysis",30849,20373,10476,707,2657
All,2008 Q3,M,"Professional, scientific and technical services",Scientific research and development,897,575,322,91,61
All,2008 Q3,M,"Professional, scientific and technical services",Advertising and market research,15022,7809,7213,404,3144
All,2008 Q3,M,"Professional, scientific and technical services","Veterinary services; Other professional, scientific and technical services",17752,10292,7460,592,5520
All,2008 Q3,N,Administrative and support services,Rental and leasing services,1929,1128,801,29,528
All,2008 Q3,N,Administrative and support services,Employment services,11375,4879,6496,312,1862
All,2008 Q3,N,Administrative and support services,"Travel agency, reservation service and related services",20616,8060,12556,585,2298
All,2008 Q3,N,Administrative and support services,Security and investigation services,38554,28904,9650,1254,164
All,2008 Q3,N,Administrative and support services,Services to buildings and landscape care,56367,18187,38180,807,1204
All,2008 Q3,N,Administrative and support services,"Office administrative, office support and other business support services",22033,10961,11072,485,4038
All,2008 Q3,P,Education,Education,153115,57511,95604,2778,7133
All,2008 Q3,Q,Human health and social work services,Human health services,86982,23118,63864,1952,5908
All,2008 Q3,Q,Human health and social work services,Residential care services,25964,3458,22506,1062,1122
All,2008 Q3,Q,Human health and social work services,Social work services,28911,6680,22231,714,1746
All,2008 Q3,R,"Arts, entertainment and recreation",Creative and performing arts activities,2355,1366,989,36,498
All,2008 Q3,R,"Arts, entertainment and recreation","Libraries, archives, museums and other cultural activities",443,161,282,10,67
All,2008 Q3,R,"Arts, entertainment and recreation",Amusement parks and theme parks,5534,3005,2529,291,5
All,2008 Q3,R,"Arts, entertainment and recreation",Sports and other entertainment services,35278,20061,15217,2120,888
All,2008 Q3,S,Other services,Activities of membership organisations,9199,3916,5283,180,933
All,2008 Q3,S,Other services,"Repair of motor vehicles, motorcycles, computers, personal and household goods",16038,13687,2351,347,5195
All,2008 Q3,S,Other services,Other personal services,41143,12358,28785,1696,9416
All,2008 Q4,C,Manufacturing,Manufacture of food products,22676,12304,10372,249,755
All,2008 Q4,C,Manufacturing,Manufacture of beverages,3522,2684,838,30,31
All,2008 Q4,C,Manufacturing,Manufacture of tobacco products,467,328,139,0,2
All,2008 Q4,C,Manufacturing,Manufacture of textiles,7588,3892,3696,25,845
All,2008 Q4,C,Manufacturing,Manufacture of wearing apparel,20114,6159,13955,36,1395
All,2008 Q4,C,Manufacturing,"Manufacture of leather and related products; Manufacture of wood and of products of wood and cork, articles of straw and plaiting materials (except furniture and toys)",498,341,157,12,152
All,2008 Q4,C,Manufacturing,Manufacture of paper and paper products,1591,1099,492,2,383
All,2008 Q4,C,Manufacturing,Printing and reproduction of recorded media,20153,14023,6130,143,3069
All,2008 Q4,C,Manufacturing,Manufacture of coke and refined petroleum products; Manufacture of chemicals and chemical products,2141,1445,696,0,223
All,2008 Q4,C,Manufacturing,"Manufacture of pharmaceuticals, medicinal chemical and botanical products",3189,1288,1901,158,236
All,2008 Q4,C,Manufacturing,"Manufacture of rubber and plastics products (except furniture, toys, sports goods and stationery)",2984,1969,1015,11,462
All,2008 Q4,C,Manufacturing,Manufacture of other non-metallic mineral products,925,761,164,9,202
All,2008 Q4,C,Manufacturing,Manufacture of basic metals,1255,1058,197,1,88
All,2008 Q4,C,Manufacturing,Manufacture of fabricated metal products (except machinery and equipment),4385,3198,1187,24,972
All,2008 Q4,C,Manufacturing,"Manufacture of computer, electronic and optical products",9718,5500,4218,37,416
All,2008 Q4,C,Manufacturing,Manufacture of electrical equipment,2876,1685,1191,7,236
All,2008 Q4,C,Manufacturing,Manufacture of machinery and equipment n.e.c.,3553,2899,654,44,663
All,2008 Q4,C,Manufacturing,Body assembly of motor vehicles; Manufacture of other transport equipment,1636,1459,177,15,129
All,2008 Q4,C,Manufacturing,Manufacture of furniture,432,370,62,0,152
All,2008 Q4,C,Manufacturing,Other manufacturing,8828,5204,3624,32,1488
All,2008 Q4,C,Manufacturing,Repair and installation of machinery and equipment,12071,10182,1889,211,1149
All,2008 Q4,B,Mining and quarrying,Quarrying and other mining of non-metal ores,98,94,4,0,4
All,2008 Q4,D,Electricity and gas supply,Electricity and gas supply,7739,6567,1172,30,20
All,2008 Q4,E,"Sewerage, waste management and remediation services",Sewerage,589,412,177,20,48
All,2008 Q4,E,"Sewerage, waste management and remediation services","Waste collection, treatment and disposal; materials recovery",2253,1410,843,12,213
All,2008 Q4,E,"Sewerage, waste management and remediation services",Remediation and other waste management services,76,76,0,0,12
All,2008 Q4,F,Construction,Construction sites (manual workers only),49448,46146,3302,11,986
All,2008 Q4,F,Construction,Public sector sites,19554,18566,988,7,383
All,2008 Q4,F,Construction,Public sector building sites,9235,8668,567,0,131
All,2008 Q4,F,Construction,Public sector civil engineering sites,10319,9898,421,7,252
All,2008 Q4,F,Construction,Private sector sites,29894,27580,2314,4,603
All,2008 Q4,F,Construction,Private sector building sites,28179,25936,2243,4,502
All,2008 Q4,F,Construction,Private sector civil engineering sites,1715,1644,71,0,101
All,2008 Q4,G,"Import/export, wholesale and retail trades",Import and export trade,512249,262019,250230,3372,95174
All,2008 Q4,G,"Import/export, wholesale and retail trades",Wholesale,64317,39509,24808,760,14401
All,2008 Q4,G,"Import/export, wholesale and retail trades",Retail trade,236910,95384,141526,3527,55989
All,2008 Q4,H,"Transportation, storage, postal and courier services",Land transport,42133,36705,5428,377,2224
All,2008 Q4,H,"Transportation, storage, postal and courier services",Water transport,10600,6352,4248,152,314
All,2008 Q4,H,"Transportation, storage, postal and courier services",Air transport,19911,7585,12326,32,116
All,2008 Q4,H,"Transportation, storage, postal and courier services",Warehousing and support services for transportation,70955,44246,26709,218,4393
All,2008 Q4,H,"Transportation, storage, postal and courier services",Postal and courier services,12239,8929,3310,102,620
All,2008 Q4,I,Accommodation and food services,Accommodation services,32508,17765,14743,301,855
All,2008 Q4,I,Accommodation and food services,Food and beverage services,208211,97918,110293,5393,12649
All,2008 Q4,J,Information and communications,Publishing,21218,11820,9398,149,1335
All,2008 Q4,J,Information and communications,"Motion picture, video and television programme production, sound recording and music publishing; Programming and broadcasting",14676,9040,5636,53,1576
All,2008 Q4,J,Information and communications,Telecommunications,15715,10296,5419,302,257
All,2008 Q4,J,Information and communications,Information technology services,32487,24656,7831,299,4772
All,2008 Q4,J,Information and communications,Information services,3621,1824,1797,32,539
All,2008 Q4,K,Financing and insurance,Financial services (except insurance and pension funding),118975,56272,62703,735,5642
All,2008 Q4,K,Financing and insurance,Insurance,12016,4482,7534,107,139
All,2008 Q4,K,Financing and insurance,Services auxiliary to financial and insurance services,50197,24859,25338,1552,10430
All,2008 Q4,L,Real estate,Real estate,104931,68290,36641,1980,10845
All,2008 Q4,M,"Professional, scientific and technical services",Legal and accounting services,45575,19462,26113,354,5784
All,2008 Q4,M,"Professional, scientific and technical services",Activities of head offices; management and management consultancy services,27834,13069,14765,342,4939
All,2008 Q4,M,"Professional, scientific and technical services","Architecture and engineering services, technical testing and analysis",31554,21107,10447,557,2552
All,2008 Q4,M,"Professional, scientific and technical services",Scientific research and development,964,638,326,69,66
All,2008 Q4,M,"Professional, scientific and technical services",Advertising and market research,14524,8018,6506,255,3084
All,2008 Q4,M,"Professional, scientific and technical services","Veterinary services; Other professional, scientific and technical services",17215,9595,7620,409,5439
All,2008 Q4,N,Administrative and support services,Rental and leasing services,1964,1087,877,6,485
All,2008 Q4,N,Administrative and support services,Employment services,11321,4633,6688,201,1742
All,2008 Q4,N,Administrative and support services,"Travel agency, reservation service and related services",20218,7785,12433,290,2266
All,2008 Q4,N,Administrative and support services,Security and investigation services,39658,29713,9945,756,159
All,2008 Q4,N,Administrative and support services,Services to buildings and landscape care,56347,18805,37542,689,1182
All,2008 Q4,N,Administrative and support services,"Office administrative, office support and other business support services",21063,9501,11562,314,3857
All,2008 Q4,P,Education,Education,154856,59276,95580,1933,7144
All,2008 Q4,Q,Human health and social work services,Human health services,88686,23751,64935,866,5941
All,2008 Q4,Q,Human health and social work services,Residential care services,25271,3617,21654,927,1147
All,2008 Q4,Q,Human health and social work services,Social work services,29098,7015,22083,395,1707
All,2008 Q4,R,"Arts, entertainment and recreation",Creative and performing arts activities,2384,1471,913,44,678
All,2008 Q4,R,"Arts, entertainment and recreation","Libraries, archives, museums and other cultural activities",400,132,268,9,67
All,2008 Q4,R,"Arts, entertainment and recreation",Amusement parks and theme parks,5051,2759,2292,45,5
All,2008 Q4,R,"Arts, entertainment and recreation",Sports and other entertainment services,34847,18421,16426,1519,975
All,2008 Q4,S,Other services,Activities of membership organisations,9032,3864,5168,195,932
All,2008 Q4,S,Other services,"Repair of motor vehicles, motorcycles, computers, personal and household goods",16041,13226,2815,245,5216
All,2008 Q4,S,Other services,Other personal services,40294,12835,27459,1167,9420
All,2009 Q1,C,Manufacturing,Manufacture of food products,22106,12033,10073,73,747
All,2009 Q1,C,Manufacturing,Manufacture of beverages,3674,2549,1125,10,31
All,2009 Q1,C,Manufacturing,Manufacture of tobacco products,463,325,138,0,2
All,2009 Q1,C,Manufacturing,Manufacture of textiles,6926,3385,3541,21,816
All,2009 Q1,C,Manufacturing,Manufacture of wearing apparel,18939,6414,12525,21,1377
All,2009 Q1,C,Manufacturing,"Manufacture of leather and related products; Manufacture of wood and of products of wood and cork, articles of straw and plaiting materials (except furniture and toys)",509,387,122,5,159
All,2009 Q1,C,Manufacturing,Manufacture of paper and paper products,1439,921,518,0,377
All,2009 Q1,C,Manufacturing,Printing and reproduction of recorded media,19906,12702,7204,80,2987
All,2009 Q1,C,Manufacturing,Manufacture of coke and refined petroleum products; Manufacture of chemicals and chemical products,2114,1360,754,0,220
All,2009 Q1,C,Manufacturing,"Manufacture of pharmaceuticals, medicinal chemical and botanical products",3317,1318,1999,99,218
All,2009 Q1,C,Manufacturing,"Manufacture of rubber and plastics products (except furniture, toys, sports goods and stationery)",2947,2054,893,22,459
All,2009 Q1,C,Manufacturing,Manufacture of other non-metallic mineral products,970,740,230,9,198
All,2009 Q1,C,Manufacturing,Manufacture of basic metals,1316,1133,183,1,74
All,2009 Q1,C,Manufacturing,Manufacture of fabricated metal products (except machinery and equipment),4020,2797,1223,1,952
All,2009 Q1,C,Manufacturing,"Manufacture of computer, electronic and optical products",9393,5610,3783,42,419
All,2009 Q1,C,Manufacturing,Manufacture of electrical equipment,2471,1526,945,19,248
All,2009 Q1,C,Manufacturing,Manufacture of machinery and equipment n.e.c.,3220,2568,652,36,563
All,2009 Q1,C,Manufacturing,Body assembly of motor vehicles; Manufacture of other transport equipment,1543,1352,191,14,124
All,2009 Q1,C,Manufacturing,Manufacture of furniture,452,368,84,0,149
All,2009 Q1,C,Manufacturing,Other manufacturing,8113,4812,3301,59,1508
All,2009 Q1,C,Manufacturing,Repair and installation of machinery and equipment,11844,10014,1830,148,1219
All,2009 Q1,B,Mining and quarrying,Quarrying and other mining of non-metal ores,97,93,4,0,4
All,2009 Q1,D,Electricity and gas supply,Electricity and gas supply,7705,6541,1164,14,20
All,2009 Q1,E,"Sewerage, waste management and remediation services",Sewerage,370,226,144,0,51
All,2009 Q1,E,"Sewerage, waste management and remediation services","Waste collection, treatment and disposal; materials recovery",2376,1438,938,26,233
All,2009 Q1,E,"Sewerage, waste management and remediation services",Remediation and other waste management services,99,49,50,0,14
All,2009 Q1,F,Construction,Construction sites (manual workers only),51944,47633,4311,3,970
All,2009 Q1,F,Construction,Public sector sites,20825,19861,964,3,382
All,2009 Q1,F,Construction,Public sector building sites,11106,10578,528,0,138
All,2009 Q1,F,Construction,Public sector civil engineering sites,9719,9283,436,3,244
All,2009 Q1,F,Construction,Private sector sites,31119,27772,3347,0,588
All,2009 Q1,F,Construction,Private sector building sites,29666,26424,3242,0,508
All,2009 Q1,F,Construction,Private sector civil engineering sites,1453,1348,105,0,80
All,2009 Q1,G,"Import/export, wholesale and retail trades",Import and export trade,496435,255765,240670,2776,93747
All,2009 Q1,G,"Import/export, wholesale and retail trades",Wholesale,63380,38580,24800,485,14330
All,2009 Q1,G,"Import/export, wholesale and retail trades",Retail trade,232014,89985,142029,2890,56791
All,2009 Q1,H,"Transportation, storage, postal and courier services",Land transport,41441,35977,5464,377,2142
All,2009 Q1,H,"Transportation, storage, postal and courier services",Water transport,10573,6603,3970,101,299
All,2009 Q1,H,"Transportation, storage, postal and courier services",Air transport,20704,7768,12936,41,106
All,2009 Q1,H,"Transportation, storage, postal and courier services",Warehousing and support services for transportation,73561,46324,27237,285,5291
All,2009 Q1,H,"Transportation, storage, postal and courier services",Postal and courier services,11698,8313,3385,170,618
All,2009 Q1,I,Accommodation and food services,Accommodation services,32041,18074,13967,293,868
All,2009 Q1,I,Accommodation and food services,Food and beverage services,206179,97648,108531,4872,12771
All,2009 Q1,J,Information and communications,Publishing,21212,11901,9311,104,1374
All,2009 Q1,J,Information and communications,"Motion picture, video and television programme production, sound recording and music publishing; Programming and broadcasting",14412,8565,5847,65,1589
All,2009 Q1,J,Information and communications,Telecommunications,15995,10353,5642,205,260
All,2009 Q1,J,Information and communications,Information technology services,30904,23156,7748,461,4731
All,2009 Q1,J,Information and communications,Information services,3601,1923,1678,45,483
All,2009 Q1,K,Financing and insurance,Financial services (except insurance and pension funding),119264,57217,62047,733,5664
All,2009 Q1,K,Financing and insurance,Insurance,12390,4538,7852,105,155
All,2009 Q1,K,Financing and insurance,Services auxiliary to financial and insurance services,50206,24425,25781,932,10699
All,2009 Q1,L,Real estate,Real estate,104368,69630,34738,1517,10914
All,2009 Q1,M,"Professional, scientific and technical services",Legal and accounting services,46571,20809,25762,281,5977
All,2009 Q1,M,"Professional, scientific and technical services",Activities of head offices; management and management consultancy services,27117,12952,14165,222,5047
All,2009 Q1,M,"Professional, scientific and technical services","Architecture and engineering services, technical testing and analysis",30527,19980,10547,359,2616
All,2009 Q1,M,"Professional, scientific and technical services",Scientific research and development,961,635,326,93,61
All,2009 Q1,M,"Professional, scientific and technical services",Advertising and market research,14318,7917,6401,318,3090
All,2009 Q1,M,"Professional, scientific and technical services","Veterinary services; Other professional, scientific and technical services",17542,9239,8303,340,5558
All,2009 Q1,N,Administrative and support services,Rental and leasing services,2305,1317,988,40,567
All,2009 Q1,N,Administrative and support services,Employment services,11593,4796,6797,106,1837
All,2009 Q1,N,Administrative and support services,"Travel agency, reservation service and related services",19905,8054,11851,310,2302
All,2009 Q1,N,Administrative and support services,Security and investigation services,38282,28740,9542,489,162
All,2009 Q1,N,Administrative and support services,Services to buildings and landscape care,56893,19720,37173,713,1263
All,2009 Q1,N,Administrative and support services,"Office administrative, office support and other business support services",20484,9442,11042,227,3925
All,2009 Q1,P,Education,Education,157029,59049,97980,1906,7433
All,2009 Q1,Q,Human health and social work services,Human health services,88495,23668,64827,2003,6027
All,2009 Q1,Q,Human health and social work services,Residential care services,25856,3800,22056,855,1106
All,2009 Q1,Q,Human health and social work services,Social work services,29365,6839,22526,416,1722
All,2009 Q1,R,"Arts, entertainment and recreation",Creative and performing arts activities,2369,1387,982,33,692
All,2009 Q1,R,"Arts, entertainment and recreation","Libraries, archives, museums and other cultural activities",429,134,295,6,58
All,2009 Q1,R,"Arts, entertainment and recreation",Amusement parks and theme parks,4659,2546,2113,67,5
All,2009 Q1,R,"Arts, entertainment and recreation",Sports and other entertainment services,34713,18147,16566,417,977
All,2009 Q1,S,Other services,Activities of membership organisations,9129,3876,5253,147,941
All,2009 Q1,S,Other services,"Repair of motor vehicles, motorcycles, computers, personal and household goods",15185,12621,2564,151,5250
All,2009 Q1,S,Other services,Other personal services,39864,13426,26438,1121,9543
All,2009 Q2,C,Manufacturing,Manufacture of food products,21703,11879,9824,141,753
All,2009 Q2,C,Manufacturing,Manufacture of beverages,3734,2632,1102,12,31
All,2009 Q2,C,Manufacturing,Manufacture of tobacco products,467,329,138,0,2
All,2009 Q2,C,Manufacturing,Manufacture of textiles,6928,3294,3634,18,828
All,2009 Q2,C,Manufacturing,Manufacture of wearing apparel,18089,7124,10965,38,1350
All,2009 Q2,C,Manufacturing,"Manufacture of leather and related products; Manufacture of wood and of products of wood and cork, articles of straw and plaiting materials (except furniture and toys)",511,357,154,0,163
All,2009 Q2,C,Manufacturing,Manufacture of paper and paper products,1439,1087,352,0,365
All,2009 Q2,C,Manufacturing,Printing and reproduction of recorded media,20009,13322,6687,135,2986
All,2009 Q2,C,Manufacturing,Manufacture of coke and refined petroleum products; Manufacture of chemicals and chemical products,2022,1369,653,4,220
All,2009 Q2,C,Manufacturing,"Manufacture of pharmaceuticals, medicinal chemical and botanical products",3437,1391,2046,44,221
All,2009 Q2,C,Manufacturing,"Manufacture of rubber and plastics products (except furniture, toys, sports goods and stationery)",2911,1961,950,9,479
All,2009 Q2,C,Manufacturing,Manufacture of other non-metallic mineral products,931,703,228,0,192
All,2009 Q2,C,Manufacturing,Manufacture of basic metals,1266,1120,146,1,76
All,2009 Q2,C,Manufacturing,Manufacture of fabricated metal products (except machinery and equipment),4158,3260,898,3,960
All,2009 Q2,C,Manufacturing,"Manufacture of computer, electronic and optical products",9549,5471,4078,45,417
All,2009 Q2,C,Manufacturing,Manufacture of electrical equipment,2527,1660,867,30,250
All,2009 Q2,C,Manufacturing,Manufacture of machinery and equipment n.e.c.,3054,2480,574,24,570
All,2009 Q2,C,Manufacturing,Body assembly of motor vehicles; Manufacture of other transport equipment,1511,1346,165,11,117
All,2009 Q2,C,Manufacturing,Manufacture of furniture,552,409,143,2,158
All,2009 Q2,C,Manufacturing,Other manufacturing,8016,4621,3395,24,1520
All,2009 Q2,C,Manufacturing,Repair and installation of machinery and equipment,11868,10085,1783,107,1244
All,2009 Q2,B,Mining and quarrying,Quarrying and other mining of non-metal ores,95,91,4,0,4
All,2009 Q2,D,Electricity and gas supply,Electricity and gas supply,7702,6526,1176,16,20
All,2009 Q2,E,"Sewerage, waste management and remediation services",Sewerage,421,221,200,0,43
All,2009 Q2,E,"Sewerage, waste management and remediation services","Waste collection, treatment and disposal; materials recovery",2307,1398,909,19,245
All,2009 Q2,E,"Sewerage, waste management and remediation services",Remediation and other waste management services,92,45,47,12,12
All,2009 Q2,F,Construction,Construction sites (manual workers only),48942,45820,3122,4,954
All,2009 Q2,F,Construction,Public sector sites,18972,17963,1009,2,369
All,2009 Q2,F,Construction,Public sector building sites,9295,8709,586,0,125
All,2009 Q2,F,Construction,Public sector civil engineering sites,9677,9254,423,2,244
All,2009 Q2,F,Construction,Private sector sites,29970,27857,2113,2,585
All,2009 Q2,F,Construction,Private sector building sites,28360,26322,2038,2,495
All,2009 Q2,F,Construction,Private sector civil engineering sites,1610,1535,75,0,90
All,2009 Q2,G,"Import/export, wholesale and retail trades",Import and export trade,491002,247192,243810,3704,94623
All,2009 Q2,G,"Import/export, wholesale and retail trades",Wholesale,63153,37713,25440,613,14389
All,2009 Q2,G,"Import/export, wholesale and retail trades",Retail trade,232556,94173,138383,3661,57632
All,2009 Q2,H,"Transportation, storage, postal and courier services",Land transport,41183,36056,5127,264,2129
All,2009 Q2,H,"Transportation, storage, postal and courier services",Water transport,10254,6343,3911,124,339
All,2009 Q2,H,"Transportation, storage, postal and courier services",Air transport,20427,7689,12738,47,112
All,2009 Q2,H,"Transportation, storage, postal and courier services",Warehousing and support services for transportation,73162,45840,27322,455,5469
All,2009 Q2,H,"Transportation, storage, postal and courier services",Postal and courier services,11841,8409,3432,99,638
All,2009 Q2,I,Accommodation and food services,Accommodation services,31548,17587,13961,274,898
All,2009 Q2,I,Accommodation and food services,Food and beverage services,207278,97733,109545,4209,13086
All,2009 Q2,J,Information and communications,Publishing,21070,11958,9112,211,1420
All,2009 Q2,J,Information and communications,"Motion picture, video and television programme production, sound recording and music publishing; Programming and broadcasting",14409,9036,5373,238,1647
All,2009 Q2,J,Information and communications,Telecommunications,16223,10388,5835,308,274
All,2009 Q2,J,Information and communications,Information technology services,31384,23588,7796,698,4820
All,2009 Q2,J,Information and communications,Information services,3786,1850,1936,60,504
All,2009 Q2,K,Financing and insurance,Financial services (except insurance and pension funding),118614,56286,62328,701,5808
All,2009 Q2,K,Financing and insurance,Insurance,12940,4879,8061,137,158
All,2009 Q2,K,Financing and insurance,Services auxiliary to financial and insurance services,50716,24250,26466,1070,10950
All,2009 Q2,L,Real estate,Real estate,105154,69815,35339,1971,11176
All,2009 Q2,M,"Professional, scientific and technical services",Legal and accounting services,46545,21377,25168,96,5963
All,2009 Q2,M,"Professional, scientific and technical services",Activities of head offices; management and management consultancy services,27510,13352,14158,273,5144
All,2009 Q2,M,"Professional, scientific and technical services","Architecture and engineering services, technical testing and analysis",31395,21420,9975,737,2747
All,2009 Q2,M,"Professional, scientific and technical services",Scientific research and development,1027,674,353,83,72
All,2009 Q2,M,"Professional, scientific and technical services",Advertising and market research,14590,8013,6577,121,3228
All,2009 Q2,M,"Professional, scientific and technical services","Veterinary services; Other professional, scientific and technical services",17545,9882,7663,353,5782
All,2009 Q2,N,Administrative and support services,Rental and leasing services,2057,1167,890,6,578
All,2009 Q2,N,Administrative and support services,Employment services,11790,5097,6693,170,1875
All,2009 Q2,N,Administrative and support services,"Travel agency, reservation service and related services",20245,7665,12580,133,2300
All,2009 Q2,N,Administrative and support services,Security and investigation services,37638,27984,9654,540,165
All,2009 Q2,N,Administrative and support services,Services to buildings and landscape care,59716,20467,39249,716,1257
All,2009 Q2,N,Administrative and support services,"Office administrative, office support and other business support services",20002,10310,9692,310,4018
All,2009 Q2,P,Education,Education,157578,58950,98628,1917,7541
All,2009 Q2,Q,Human health and social work services,Human health services,90060,24192,65868,2059,5959
All,2009 Q2,Q,Human health and social work services,Residential care services,26590,3654,22936,981,1121
All,2009 Q2,Q,Human health and social work services,Social work services,28864,6502,22362,523,1755
All,2009 Q2,R,"Arts, entertainment and recreation",Creative and performing arts activities,2304,1390,914,14,747
All,2009 Q2,R,"Arts, entertainment and recreation","Libraries, archives, museums and other cultural activities",380,149,231,5,54
All,2009 Q2,R,"Arts, entertainment and recreation",Amusement parks and theme parks,5121,2814,2307,665,5
All,2009 Q2,R,"Arts, entertainment and recreation",Sports and other entertainment services,34928,18445,16483,192,1010
All,2009 Q2,S,Other services,Activities of membership organisations,9224,4270,4954,181,937
All,2009 Q2,S,Other services,"Repair of motor vehicles, motorcycles, computers, personal and household goods",15936,13204,2732,270,5323
All,2009 Q2,S,Other services,Other personal services,40621,12927,27694,1631,9713
All,2009 Q3,C,Manufacturing,Manufacture of food products,21747,11339,10408,398,766
All,2009 Q3,C,Manufacturing,Manufacture of beverages,3765,2653,1112,12,31
All,2009 Q3,C,Manufacturing,Manufacture of tobacco products,474,338,136,0,2
All,2009 Q3,C,Manufacturing,Manufacture of textiles,6644,3816,2828,8,857
All,2009 Q3,C,Manufacturing,Manufacture of wearing apparel,17548,6788,10760,101,1377
All,2009 Q3,C,Manufacturing,"Manufacture of leather and related products; Manufacture of wood and of products of wood and cork, articles of straw and plaiting materials (except furniture and toys)",472,356,116,0,154
All,2009 Q3,C,Manufacturing,Manufacture of paper and paper products,1501,970,531,37,379
All,2009 Q3,C,Manufacturing,Printing and reproduction of recorded media,20292,12837,7455,221,3060
All,2009 Q3,C,Manufacturing,Manufacture of coke and refined petroleum products; Manufacture of chemicals and chemical products,2027,1223,804,9,218
All,2009 Q3,C,Manufacturing,"Manufacture of pharmaceuticals, medicinal chemical and botanical products",3493,1502,1991,35,224
All,2009 Q3,C,Manufacturing,"Manufacture of rubber and plastics products (except furniture, toys, sports goods and stationery)",2831,1663,1168,2,469
All,2009 Q3,C,Manufacturing,Manufacture of other non-metallic mineral products,1081,937,144,2,212
All,2009 Q3,C,Manufacturing,Manufacture of basic metals,1275,1080,195,3,89
All,2009 Q3,C,Manufacturing,Manufacture of fabricated metal products (except machinery and equipment),4101,3331,770,17,940
All,2009 Q3,C,Manufacturing,"Manufacture of computer, electronic and optical products",9719,5900,3819,62,415
All,2009 Q3,C,Manufacturing,Manufacture of electrical equipment,2401,1412,989,71,268
All,2009 Q3,C,Manufacturing,Manufacture of machinery and equipment n.e.c.,3126,2409,717,6,565
All,2009 Q3,C,Manufacturing,Body assembly of motor vehicles; Manufacture of other transport equipment,1410,1230,180,38,112
All,2009 Q3,C,Manufacturing,Manufacture of furniture,583,489,94,34,170
All,2009 Q3,C,Manufacturing,Other manufacturing,8394,5046,3348,85,1523
All,2009 Q3,C,Manufacturing,Repair and installation of machinery and equipment,11805,10129,1676,66,1259
All,2009 Q3,B,Mining and quarrying,Quarrying and other mining of non-metal ores,95,91,4,0,4
All,2009 Q3,D,Electricity and gas supply,Electricity and gas supply,7717,6532,1185,11,20
All,2009 Q3,E,"Sewerage, waste management and remediation services",Sewerage,454,364,90,1,47
All,2009 Q3,E,"Sewerage, waste management and remediation services","Waste collection, treatment and disposal; materials recovery",2160,1319,841,19,237
All,2009 Q3,E,"Sewerage, waste management and remediation services",Remediation and other waste management services,78,38,40,1,12
All,2009 Q3,F,Construction,Construction sites (manual workers only),47965,44016,3949,18,987
All,2009 Q3,F,Construction,Public sector sites,18931,17846,1085,15,376
All,2009 Q3,F,Construction,Public sector building sites,9540,8880,660,9,121
All,2009 Q3,F,Construction,Public sector civil engineering sites,9391,8966,425,6,255
All,2009 Q3,F,Construction,Private sector sites,29034,26170,2864,3,611
All,2009 Q3,F,Construction,Private sector building sites,27301,24612,2689,3,520
All,2009 Q3,F,Construction,Private sector civil engineering sites,1733,1558,175,0,91
All,2009 Q3,G,"Import/export, wholesale and retail trades",Import and export trade,494955,249598,245357,3460,94727
All,2009 Q3,G,"Import/export, wholesale and retail trades",Wholesale,63321,37716,25605,1040,14474
All,2009 Q3,G,"Import/export, wholesale and retail trades",Retail trade,236827,98026,138801,4216,58022
All,2009 Q3,H,"Transportation, storage, postal and courier services",Land transport,42156,36754,5402,353,2198
All,2009 Q3,H,"Transportation, storage, postal and courier services",Water transport,9924,6206,3718,33,314
All,2009 Q3,H,"Transportation, storage, postal and courier services",Air transport,20483,7776,12707,41,113
All,2009 Q3,H,"Transportation, storage, postal and courier services",Warehousing and support services for transportation,73235,45794,27441,641,5539
All,2009 Q3,H,"Transportation, storage, postal and courier services",Postal and courier services,11917,8363,3554,76,653
All,2009 Q3,I,Accommodation and food services,Accommodation services,31390,17221,14169,547,873
All,2009 Q3,I,Accommodation and food services,Food and beverage services,208817,94810,114007,6527,13351
All,2009 Q3,J,Information and communications,Publishing,20611,12050,8561,210,1407
All,2009 Q3,J,Information and communications,"Motion picture, video and television programme production, sound recording and music publishing; Programming and broadcasting",13914,8470,5444,117,1818
All,2009 Q3,J,Information and communications,Telecommunications,16400,10604,5796,330,283
All,2009 Q3,J,Information and communications,Information technology services,33014,24108,8906,663,4720
All,2009 Q3,J,Information and communications,Information services,3971,2164,1807,33,489
All,2009 Q3,K,Financing and insurance,Financial services (except insurance and pension funding),118337,56940,61397,997,5868
All,2009 Q3,K,Financing and insurance,Insurance,12940,4888,8052,104,149
All,2009 Q3,K,Financing and insurance,Services auxiliary to financial and insurance services,50896,25755,25141,2717,10847
All,2009 Q3,L,Real estate,Real estate,107123,69350,37773,2312,11487
All,2009 Q3,M,"Professional, scientific and technical services",Legal and accounting services,46299,20641,25658,170,5969
All,2009 Q3,M,"Professional, scientific and technical services",Activities of head offices; management and management consultancy services,27263,12949,14314,514,5273
All,2009 Q3,M,"Professional, scientific and technical services","Architecture and engineering services, technical testing and analysis",32490,21926,10564,699,2809
All,2009 Q3,M,"Professional, scientific and technical services",Scientific research and development,1051,661,390,52,76
All,2009 Q3,M,"Professional, scientific and technical services",Advertising and market research,14731,7986,6745,260,3258
All,2009 Q3,M,"Professional, scientific and technical services","Veterinary services; Other professional, scientific and technical services",18586,10229,8357,441,6001
All,2009 Q3,N,Administrative and support services,Rental and leasing services,2078,1223,855,4,580
All,2009 Q3,N,Administrative and support services,Employment services,11435,5344,6091,372,1929
All,2009 Q3,N,Administrative and support services,"Travel agency, reservation service and related services",20205,7938,12267,438,2287
All,2009 Q3,N,Administrative and support services,Security and investigation services,39510,29179,10331,825,180
All,2009 Q3,N,Administrative and support services,Services to buildings and landscape care,60931,19983,40948,769,1282
All,2009 Q3,N,Administrative and support services,"Office administrative, office support and other business support services",19812,9856,9956,446,4146
All,2009 Q3,P,Education,Education,161723,59555,102168,2337,7974
All,2009 Q3,Q,Human health and social work services,Human health services,90404,24632,65772,1413,6009
All,2009 Q3,Q,Human health and social work services,Residential care services,26791,3284,23507,729,1129
All,2009 Q3,Q,Human health and social work services,Social work services,29044,6325,22719,462,1766
All,2009 Q3,R,"Arts, entertainment and recreation",Creative and performing arts activities,2443,1513,930,106,721
All,2009 Q3,R,"Arts, entertainment and recreation","Libraries, archives, museums and other cultural activities",419,118,301,2,54
All,2009 Q3,R,"Arts, entertainment and recreation",Amusement parks and theme parks,5788,3145,2643,69,5
All,2009 Q3,R,"Arts, entertainment and recreation",Sports and other entertainment services,34394,19586,14808,701,1028
All,2009 Q3,S,Other services,Activities of membership organisations,9020,3924,5096,128,942
All,2009 Q3,S,Other services,"Repair of motor vehicles, motorcycles, computers, personal and household goods",16164,13713,2451,245,5229
All,2009 Q3,S,Other services,Other personal services,40889,12460,28429,1917,9779
All,2009 Q4,C,Manufacturing,Manufacture of food products,22456,10906,11550,302,796
All,2009 Q4,C,Manufacturing,Manufacture of beverages,3618,2633,985,25,30
All,2009 Q4,C,Manufacturing,Manufacture of tobacco products,466,333,133,0,2
All,2009 Q4,C,Manufacturing,Manufacture of textiles,6995,3872,3123,52,839
All,2009 Q4,C,Manufacturing,Manufacture of wearing apparel,17127,6536,10591,73,1327
All,2009 Q4,C,Manufacturing,"Manufacture of leather and related products; Manufacture of wood and of products of wood and cork, articles of straw and plaiting materials (except furniture and toys)",620,403,217,0,166
All,2009 Q4,C,Manufacturing,Manufacture of paper and paper products,1529,968,561,75,391
All,2009 Q4,C,Manufacturing,Printing and reproduction of recorded media,19835,13627,6208,144,3022
All,2009 Q4,C,Manufacturing,Manufacture of coke and refined petroleum products; Manufacture of chemicals and chemical products,2083,1660,423,7,222
All,2009 Q4,C,Manufacturing,"Manufacture of pharmaceuticals, medicinal chemical and botanical products",3461,1347,2114,24,229
All,2009 Q4,C,Manufacturing,"Manufacture of rubber and plastics products (except furniture, toys, sports goods and stationery)",2907,2048,859,5,442
All,2009 Q4,C,Manufacturing,Manufacture of other non-metallic mineral products,1024,841,183,2,200
All,2009 Q4,C,Manufacturing,Manufacture of basic metals,1232,1038,194,17,94
All,2009 Q4,C,Manufacturing,Manufacture of fabricated metal products (except machinery and equipment),4262,3010,1252,46,925
All,2009 Q4,C,Manufacturing,"Manufacture of computer, electronic and optical products",9531,5346,4185,137,393
All,2009 Q4,C,Manufacturing,Manufacture of electrical equipment,2468,1684,784,6,253
All,2009 Q4,C,Manufacturing,Manufacture of machinery and equipment n.e.c.,3004,2482,522,22,583
All,2009 Q4,C,Manufacturing,Body assembly of motor vehicles; Manufacture of other transport equipment,1401,1234,167,18,114
All,2009 Q4,C,Manufacturing,Manufacture of furniture,528,437,91,0,154
All,2009 Q4,C,Manufacturing,Other manufacturing,8623,5182,3441,61,1471
All,2009 Q4,C,Manufacturing,Repair and installation of machinery and equipment,11737,9920,1817,133,1271
All,2009 Q4,B,Mining and quarrying,Quarrying and other mining of non-metal ores,87,83,4,0,3
All,2009 Q4,D,Electricity and gas supply,Electricity and gas supply,7672,6487,1185,26,20
All,2009 Q4,E,"Sewerage, waste management and remediation services",Sewerage,490,279,211,0,47
All,2009 Q4,E,"Sewerage, waste management and remediation services","Waste collection, treatment and disposal; materials recovery",2615,1911,704,4,233
All,2009 Q4,E,"Sewerage, waste management and remediation services",Remediation and other waste management services,93,56,37,1,12
All,2009 Q4,F,Construction,Construction sites (manual workers only),53154,49674,3480,30,992
All,2009 Q4,F,Construction,Public sector sites,21701,20546,1155,10,385
All,2009 Q4,F,Construction,Public sector building sites,11165,10442,723,5,116
All,2009 Q4,F,Construction,Public sector civil engineering sites,10536,10104,432,5,269
All,2009 Q4,F,Construction,Private sector sites,31453,29128,2325,20,607
All,2009 Q4,F,Construction,Private sector building sites,29778,27532,2246,20,511
All,2009 Q4,F,Construction,Private sector civil engineering sites,1675,1596,79,0,96
All,2009 Q4,G,"Import/export, wholesale and retail trades",Import and export trade,498545,249390,249155,3904,97253
All,2009 Q4,G,"Import/export, wholesale and retail trades",Wholesale,64006,39738,24268,908,14686
All,2009 Q4,G,"Import/export, wholesale and retail trades",Retail trade,239782,95348,144434,4575,59385
All,2009 Q4,H,"Transportation, storage, postal and courier services",Land transport,42399,36631,5768,306,2190
All,2009 Q4,H,"Transportation, storage, postal and courier services",Water transport,10083,6340,3743,36,315
All,2009 Q4,H,"Transportation, storage, postal and courier services",Air transport,20574,7866,12708,68,125
All,2009 Q4,H,"Transportation, storage, postal and courier services",Warehousing and support services for transportation,74189,46120,28069,829,5528
All,2009 Q4,H,"Transportation, storage, postal and courier services",Postal and courier services,12052,8781,3271,218,647
All,2009 Q4,I,Accommodation and food services,Accommodation services,31859,17533,14326,547,899
All,2009 Q4,I,Accommodation and food services,Food and beverage services,215186,100687,114499,4178,13780
All,2009 Q4,J,Information and communications,Publishing,20685,11677,9008,266,1483
All,2009 Q4,J,Information and communications,"Motion picture, video and television programme production, sound recording and music publishing; Programming and broadcasting",13869,8840,5029,125,1754
All,2009 Q4,J,Information and communications,Telecommunications,17221,11090,6131,356,287
All,2009 Q4,J,Information and communications,Information technology services,32120,23555,8565,612,4971
All,2009 Q4,J,Information and communications,Information services,3952,2131,1821,68,531
All,2009 Q4,K,Financing and insurance,Financial services (except insurance and pension funding),120774,57344,63430,1308,6131
All,2009 Q4,K,Financing and insurance,Insurance,13075,5014,8061,229,152
All,2009 Q4,K,Financing and insurance,Services auxiliary to financial and insurance services,51765,25753,26012,1363,11291
All,2009 Q4,L,Real estate,Real estate,108410,68562,39848,1692,11992
All,2009 Q4,M,"Professional, scientific and technical services",Legal and accounting services,46215,20323,25892,285,6163
All,2009 Q4,M,"Professional, scientific and technical services",Activities of head offices; management and management consultancy services,27807,12473,15334,529,5271
All,2009 Q4,M,"Professional, scientific and technical services","Architecture and engineering services, technical testing and analysis",34046,21789,12257,544,2870
All,2009 Q4,M,"Professional, scientific and technical services",Scientific research and development,1081,682,399,44,87
All,2009 Q4,M,"Professional, scientific and technical services",Advertising and market research,14172,7149,7023,136,3288
All,2009 Q4,M,"Professional, scientific and technical services","Veterinary services; Other professional, scientific and technical services",18038,9940,8098,255,6203
All,2009 Q4,N,Administrative and support services,Rental and leasing services,2246,1194,1052,24,585
All,2009 Q4,N,Administrative and support services,Employment services,11757,4821,6936,132,1881
All,2009 Q4,N,Administrative and support services,"Travel agency, reservation service and related services",20291,8109,12182,257,2345
All,2009 Q4,N,Administrative and support services,Security and investigation services,40421,30004,10417,622,185
All,2009 Q4,N,Administrative and support services,Services to buildings and landscape care,66030,22202,43828,790,1334
All,2009 Q4,N,Administrative and support services,"Office administrative, office support and other business support services",20248,9674,10574,419,4208
All,2009 Q4,P,Education,Education,164660,61710,102950,1865,8372
All,2009 Q4,Q,Human health and social work services,Human health services,91537,24556,66981,793,6228
All,2009 Q4,Q,Human health and social work services,Residential care services,27403,4092,23311,835,1155
All,2009 Q4,Q,Human health and social work services,Social work services,28722,6763,21959,672,1797
All,2009 Q4,R,"Arts, entertainment and recreation",Creative and performing arts activities,2447,1404,1043,17,776
All,2009 Q4,R,"Arts, entertainment and recreation","Libraries, archives, museums and other cultural activities",425,127,298,1,64
All,2009 Q4,R,"Arts, entertainment and recreation",Amusement parks and theme parks,5168,2834,2334,77,5
All,2009 Q4,S,Other services,Activities of membership organisations,9058,4066,4992,149,977
All,2009 Q4,S,Other services,"Repair of motor vehicles, motorcycles, computers, personal and household goods",16853,13961,2892,338,5453
All,2009 Q4,S,Other services,Other personal services,41404,12682,28722,1807,10001
All,2010 Q1,C,Manufacturing,Manufacture of food products,22058,11581,10477,350,811
All,2010 Q1,C,Manufacturing,Manufacture of beverages,3504,2597,907,52,28
All,2010 Q1,C,Manufacturing,Manufacture of tobacco products,465,334,131,0,2
All,2010 Q1,C,Manufacturing,Manufacture of textiles,6635,3617,3018,36,820
All,2010 Q1,C,Manufacturing,Manufacture of wearing apparel,16157,5691,10466,75,1216
All,2010 Q1,C,Manufacturing,"Manufacture of leather and related products; Manufacture of wood and of products of wood and cork, articles of straw and plaiting materials (except furniture and toys)",515,340,175,4,162
All,2010 Q1,C,Manufacturing,Manufacture of paper and paper products,1572,1063,509,50,380
All,2010 Q1,C,Manufacturing,Printing and reproduction of recorded media,19717,13375,6342,205,2974
All,2010 Q1,C,Manufacturing,Manufacture of coke and refined petroleum products; Manufacture of chemicals and chemical products,2183,1604,579,25,222
All,2010 Q1,C,Manufacturing,"Manufacture of pharmaceuticals, medicinal chemical and botanical products",3491,1428,2063,31,227
All,2010 Q1,C,Manufacturing,"Manufacture of rubber and plastics products (except furniture, toys, sports goods and stationery)",2874,1753,1121,26,450
All,2010 Q1,C,Manufacturing,Manufacture of other non-metallic mineral products,1054,815,239,5,210
All,2010 Q1,C,Manufacturing,Manufacture of basic metals,1195,983,212,56,93
All,2010 Q1,C,Manufacturing,Manufacture of fabricated metal products (except machinery and equipment),4073,3063,1010,33,910
All,2010 Q1,C,Manufacturing,"Manufacture of computer, electronic and optical products",9429,5224,4205,173,384
All,2010 Q1,C,Manufacturing,Manufacture of electrical equipment,2302,1494,808,5,236
All,2010 Q1,C,Manufacturing,Manufacture of machinery and equipment n.e.c.,2931,2425,506,47,560
All,2010 Q1,C,Manufacturing,Body assembly of motor vehicles; Manufacture of other transport equipment,1437,1251,186,3,115
All,2010 Q1,C,Manufacturing,Manufacture of furniture,500,408,92,0,154
All,2010 Q1,C,Manufacturing,Other manufacturing,8667,4922,3745,72,1488
All,2010 Q1,C,Manufacturing,Repair and installation of machinery and equipment,11808,10249,1559,295,1284
All,2010 Q1,B,Mining and quarrying,Quarrying and other mining of non-metal ores,93,88,5,0,3
All,2010 Q1,D,Electricity and gas supply,Electricity and gas supply,7612,6444,1168,18,19
All,2010 Q1,E,"Sewerage, waste management and remediation services",Sewerage,425,296,129,4,46
All,2010 Q1,E,"Sewerage, waste management and remediation services","Waste collection, treatment and disposal; materials recovery",2580,1564,1016,30,234
All,2010 Q1,E,"Sewerage, waste management and remediation services",Remediation and other waste management services,70,33,37,0,10
All,2010 Q1,F,Construction,Construction sites (manual workers only),53913,50608,3305,47,1006
All,2010 Q1,F,Construction,Public sector sites,23849,22584,1265,47,396
All,2010 Q1,F,Construction,Public sector building sites,11532,10786,746,3,120
All,2010 Q1,F,Construction,Public sector civil engineering sites,12317,11798,519,44,276
All,2010 Q1,F,Construction,Private sector sites,30064,28024,2040,0,610
All,2010 Q1,F,Construction,Private sector building sites,28429,26502,1927,0,529
All,2010 Q1,F,Construction,Private sector civil engineering sites,1635,1522,113,0,81
All,2010 Q1,G,"Import/export, wholesale and retail trades",Import and export trade,499695,256100,243595,5364,99477
All,2010 Q1,G,"Import/export, wholesale and retail trades",Wholesale,64604,38601,26003,1192,14884
All,2010 Q1,G,"Import/export, wholesale and retail trades",Retail trade,240598,98235,142363,4866,60079
All,2010 Q1,H,"Transportation, storage, postal and courier services",Land transport,42361,36698,5663,415,2256
All,2010 Q1,H,"Transportation, storage, postal and courier services",Water transport,10374,6918,3456,58,340
All,2010 Q1,H,"Transportation, storage, postal and courier services",Air transport,20467,7967,12500,207,125
All,2010 Q1,H,"Transportation, storage, postal and courier services",Warehousing and support services for transportation,74717,45236,29481,795,5682
All,2010 Q1,H,"Transportation, storage, postal and courier services",Postal and courier services,11516,8058,3458,188,669
All,2010 Q1,I,Accommodation and food services,Accommodation services,31439,17263,14176,761,948
All,2010 Q1,I,Accommodation and food services,Food and beverage services,215915,100736,115179,5376,14155
All,2010 Q1,J,Information and communications,Publishing,20623,10984,9639,274,1468
All,2010 Q1,J,Information and communications,"Motion picture, video and television programme production, sound recording and music publishing; Programming and broadcasting",13401,8317,5084,135,1819
All,2010 Q1,J,Information and communications,Telecommunications,17437,11335,6102,625,284
All,2010 Q1,J,Information and communications,Information technology services,32160,24398,7762,1097,5117
All,2010 Q1,J,Information and communications,Information services,3809,1911,1898,114,518
All,2010 Q1,K,Financing and insurance,Financial services (except insurance and pension funding),120217,57974,62243,1757,6230
All,2010 Q1,K,Financing and insurance,Insurance,12393,4712,7681,314,158
All,2010 Q1,K,Financing and insurance,Services auxiliary to financial and insurance services,54044,26585,27459,1630,11331
All,2010 Q1,L,Real estate,Real estate,109676,71046,38630,2455,12016
All,2010 Q1,M,"Professional, scientific and technical services",Legal and accounting services,46503,20376,26127,433,6139
All,2010 Q1,M,"Professional, scientific and technical services",Activities of head offices; management and management consultancy services,27526,13624,13902,277,5425
All,2010 Q1,M,"Professional, scientific and technical services","Architecture and engineering services, technical testing and analysis",33665,21630,12035,609,2915
All,2010 Q1,M,"Professional, scientific and technical services",Scientific research and development,1147,751,396,99,106
All,2010 Q1,M,"Professional, scientific and technical services",Advertising and market research,13819,7187,6632,246,3381
All,2010 Q1,M,"Professional, scientific and technical services","Veterinary services; Other professional, scientific and technical services",18316,10110,8206,565,6295
All,2010 Q1,N,Administrative and support services,Rental and leasing services,2222,1233,989,40,594
All,2010 Q1,N,Administrative and support services,Employment services,11895,5202,6693,143,2025
All,2010 Q1,N,Administrative and support services,"Travel agency, reservation service and related services",19639,7666,11973,576,2307
All,2010 Q1,N,Administrative and support services,Security and investigation services,39772,29427,10345,1019,185
All,2010 Q1,N,Administrative and support services,Services to buildings and landscape care,65087,21851,43236,797,1362
All,2010 Q1,N,Administrative and support services,"Office administrative, office support and other business support services",20339,9869,10470,835,4203
All,2010 Q1,P,Education,Education,165602,61381,104221,2209,8498
All,2010 Q1,Q,Human health and social work services,Human health services,92140,24274,67866,2461,6230
All,2010 Q1,Q,Human health and social work services,Residential care services,27380,3473,23907,1153,1159
All,2010 Q1,Q,Human health and social work services,Social work services,28963,6815,22148,721,1790
All,2010 Q1,R,"Arts, entertainment and recreation",Creative and performing arts activities,2198,1289,909,98,840
All,2010 Q1,R,"Arts, entertainment and recreation","Libraries, archives, museums and other cultural activities",429,171,258,13,64
All,2010 Q1,R,"Arts, entertainment and recreation",Amusement parks and theme parks,4695,2585,2110,61,5
All,2010 Q1,R,"Arts, entertainment and recreation",Sports and other entertainment services,38411,21588,16823,1587,1134
All,2010 Q1,S,Other services,Activities of membership organisations,9010,3799,5211,145,981
All,2010 Q1,S,Other services,"Repair of motor vehicles, motorcycles, computers, personal and household goods",16444,13571,2873,314,5588
All,2010 Q1,S,Other services,Other personal services,42412,13828,28584,2291,10148
All,2010 Q2,C,Manufacturing,Manufacture of food products,21735,11268,10467,341,783
All,2010 Q2,C,Manufacturing,Manufacture of beverages,3823,2765,1058,33,29
All,2010 Q2,C,Manufacturing,Manufacture of tobacco products,461,330,131,0,2
All,2010 Q2,C,Manufacturing,Manufacture of textiles,6377,3630,2747,49,793
All,2010 Q2,C,Manufacturing,Manufacture of wearing apparel,15263,6080,9183,59,1159
All,2010 Q2,C,Manufacturing,"Manufacture of leather and related products; Manufacture of wood and of products of wood and cork, articles of straw and plaiting materials (except furniture and toys)",538,357,181,0,145
All,2010 Q2,C,Manufacturing,Manufacture of paper and paper products,1543,974,569,6,375
All,2010 Q2,C,Manufacturing,Printing and reproduction of recorded media,19369,12848,6521,55,2917
All,2010 Q2,C,Manufacturing,Manufacture of coke and refined petroleum products; Manufacture of chemicals and chemical products,2093,1494,599,59,210
All,2010 Q2,C,Manufacturing,"Manufacture of pharmaceuticals, medicinal chemical and botanical products",3457,1506,1951,16,232
All,2010 Q2,C,Manufacturing,"Manufacture of rubber and plastics products (except furniture, toys, sports goods and stationery)",2831,1418,1413,24,455
All,2010 Q2,C,Manufacturing,Manufacture of other non-metallic mineral products,1050,876,174,0,205
All,2010 Q2,C,Manufacturing,Manufacture of basic metals,1119,923,196,38,91
All,2010 Q2,C,Manufacturing,Manufacture of fabricated metal products (except machinery and equipment),3921,2751,1170,33,892
All,2010 Q2,C,Manufacturing,"Manufacture of computer, electronic and optical products",9475,5606,3869,101,408
All,2010 Q2,C,Manufacturing,Manufacture of electrical equipment,2232,1536,696,17,246
All,2010 Q2,C,Manufacturing,Manufacture of machinery and equipment n.e.c.,2823,2212,611,59,546
All,2010 Q2,C,Manufacturing,Body assembly of motor vehicles; Manufacture of other transport equipment,1392,1179,213,11,109
All,2010 Q2,C,Manufacturing,Manufacture of furniture,538,384,154,3,163
All,2010 Q2,C,Manufacturing,Other manufacturing,7969,4567,3402,81,1477
All,2010 Q2,C,Manufacturing,Repair and installation of machinery and equipment,11807,10007,1800,432,1269
All,2010 Q2,B,Mining and quarrying,Quarrying and other mining of non-metal ores,95,88,7,0,3
All,2010 Q2,D,Electricity and gas supply,Electricity and gas supply,7616,6434,1182,40,18
All,2010 Q2,E,"Sewerage, waste management and remediation services",Sewerage,412,269,143,1,44
All,2010 Q2,E,"Sewerage, waste management and remediation services","Waste collection, treatment and disposal; materials recovery",2632,1670,962,28,255
All,2010 Q2,E,"Sewerage, waste management and remediation services",Remediation and other waste management services,92,47,45,2,10
All,2010 Q2,F,Construction,Construction sites (manual workers only),55523,51603,3920,59,1081
All,2010 Q2,F,Construction,Public sector sites,23704,22298,1406,45,411
All,2010 Q2,F,Construction,Public sector building sites,10325,9560,765,7,123
All,2010 Q2,F,Construction,Public sector civil engineering sites,13379,12738,641,38,288
All,2010 Q2,F,Construction,Private sector sites,31819,29305,2514,14,670
All,2010 Q2,F,Construction,Private sector building sites,30154,27759,2395,14,566
All,2010 Q2,F,Construction,Private sector civil engineering sites,1665,1546,119,0,104
All,2010 Q2,G,"Import/export, wholesale and retail trades",Import and export trade,498329,256337,241992,5497,100161
All,2010 Q2,G,"Import/export, wholesale and retail trades",Wholesale,63825,38041,25784,594,14851
All,2010 Q2,G,"Import/export, wholesale and retail trades",Retail trade,240803,96463,144340,4396,60108
All,2010 Q2,H,"Transportation, storage, postal and courier services",Land transport,42236,36723,5513,267,2213
All,2010 Q2,H,"Transportation, storage, postal and courier services",Water transport,10455,6700,3755,117,343
All,2010 Q2,H,"Transportation, storage, postal and courier services",Air transport,20693,8205,12488,245,124
All,2010 Q2,H,"Transportation, storage, postal and courier services",Warehousing and support services for transportation,75414,46261,29153,941,5756
All,2010 Q2,H,"Transportation, storage, postal and courier services",Postal and courier services,11611,7357,4254,413,694
All,2010 Q2,I,Accommodation and food services,Accommodation services,31998,17515,14483,769,920
All,2010 Q2,I,Accommodation and food services,Food and beverage services,215466,100536,114930,5863,14155
All,2010 Q2,J,Information and communications,Publishing,20694,11404,9290,326,1492
All,2010 Q2,J,Information and communications,"Motion picture, video and television programme production, sound recording and music publishing; Programming and broadcasting",13400,8587,4813,127,1874
All,2010 Q2,J,Information and communications,Telecommunications,17089,11136,5953,531,288
All,2010 Q2,J,Information and communications,Information technology services,33181,25246,7935,1220,5238
All,2010 Q2,J,Information and communications,Information services,4021,2264,1757,98,538
All,2010 Q2,K,Financing and insurance,Financial services (except insurance and pension funding),121697,57235,64462,2073,6303
All,2010 Q2,K,Financing and insurance,Insurance,13259,4957,8302,290,159
All,2010 Q2,K,Financing and insurance,Services auxiliary to financial and insurance services,55883,27952,27931,1691,11691
All,2010 Q2,L,Real estate,Real estate,110068,70004,40064,2334,12163
All,2010 Q2,M,"Professional, scientific and technical services",Legal and accounting services,46748,20646,26102,434,6216
All,2010 Q2,M,"Professional, scientific and technical services",Activities of head offices; management and management consultancy services,27982,12920,15062,432,5548
All,2010 Q2,M,"Professional, scientific and technical services","Architecture and engineering services, technical testing and analysis",33799,22598,11201,494,2927
All,2010 Q2,M,"Professional, scientific and technical services",Scientific research and development,1164,752,412,107,94
All,2010 Q2,M,"Professional, scientific and technical services",Advertising and market research,13918,7575,6343,262,3333
All,2010 Q2,M,"Professional, scientific and technical services","Veterinary services; Other professional, scientific and technical services",18365,10161,8204,504,6484
All,2010 Q2,N,Administrative and support services,Rental and leasing services,2275,1373,902,15,622
All,2010 Q2,N,Administrative and support services,Employment services,12633,5418,7215,545,2165
All,2010 Q2,N,Administrative and support services,"Travel agency, reservation service and related services",19283,7850,11433,483,2295
All,2010 Q2,N,Administrative and support services,Security and investigation services,39631,29071,10560,1208,188
All,2010 Q2,N,Administrative and support services,Services to buildings and landscape care,67966,23222,44744,788,1331
All,2010 Q2,N,Administrative and support services,"Office administrative, office support and other business support services",19965,9805,10160,515,4410
All,2010 Q2,P,Education,Education,166078,60602,105476,2281,9026
All,2010 Q2,Q,Human health and social work services,Human health services,92005,24602,67403,2622,6323
All,2010 Q2,Q,Human health and social work services,Residential care services,27223,3523,23700,1024,1154
All,2010 Q2,Q,Human health and social work services,Social work services,28967,6749,22218,754,1830
All,2010 Q2,R,"Arts, entertainment and recreation",Creative and performing arts activities,2445,1338,1107,14,859
All,2010 Q2,R,"Arts, entertainment and recreation","Libraries, archives, museums and other cultural activities",439,167,272,6,63
All,2010 Q2,R,"Arts, entertainment and recreation",Amusement parks and theme parks,5219,2869,2350,78,5
All,2010 Q2,R,"Arts, entertainment and recreation",Sports and other entertainment services,35351,20195,15156,311,1141
All,2010 Q2,S,Other services,Activities of membership organisations,9146,3884,5262,299,1016
All,2010 Q2,S,Other services,"Repair of motor vehicles, motorcycles, computers, personal and household goods",17011,13836,3175,437,5758
All,2010 Q2,S,Other services,Other personal services,43052,13247,29805,2244,10369
All,2010 Q3,C,Manufacturing,Manufacture of food products,21399,11210,10189,292,762
All,2010 Q3,C,Manufacturing,Manufacture of beverages,3889,2734,1155,48,30
All,2010 Q3,C,Manufacturing,Manufacture of tobacco products,464,332,132,0,2
All,2010 Q3,C,Manufacturing,Manufacture of textiles,6072,3436,2636,48,771
All,2010 Q3,C,Manufacturing,Manufacture of wearing apparel,14339,4607,9732,11,1101
All,2010 Q3,C,Manufacturing,"Manufacture of leather and related products; Manufacture of wood and of products of wood and cork, articles of straw and plaiting materials (except furniture and toys)",473,317,156,0,136
All,2010 Q3,C,Manufacturing,Manufacture of paper and paper products,1576,987,589,12,361
All,2010 Q3,C,Manufacturing,Printing and reproduction of recorded media,19522,13166,6356,216,2947
All,2010 Q3,C,Manufacturing,Manufacture of coke and refined petroleum products; Manufacture of chemicals and chemical products,2263,1642,621,3,232
All,2010 Q3,C,Manufacturing,"Manufacture of pharmaceuticals, medicinal chemical and botanical products",3439,1378,2061,98,228
All,2010 Q3,C,Manufacturing,"Manufacture of rubber and plastics products (except furniture, toys, sports goods and stationery)",2817,1709,1108,7,474
All,2010 Q3,C,Manufacturing,Manufacture of other non-metallic mineral products,1004,844,160,11,197
All,2010 Q3,C,Manufacturing,Manufacture of basic metals,1177,931,246,41,93
All,2010 Q3,C,Manufacturing,Manufacture of fabricated metal products (except machinery and equipment),3622,2618,1004,50,829
All,2010 Q3,C,Manufacturing,"Manufacture of computer, electronic and optical products",9245,5373,3872,219,397
All,2010 Q3,C,Manufacturing,Manufacture of electrical equipment,2089,1031,1058,21,244
All,2010 Q3,C,Manufacturing,Manufacture of machinery and equipment n.e.c.,2544,2057,487,69,516
All,2010 Q3,C,Manufacturing,Body assembly of motor vehicles; Manufacture of other transport equipment,1391,1227,164,49,103
All,2010 Q3,C,Manufacturing,Manufacture of furniture,489,424,65,7,150
All,2010 Q3,C,Manufacturing,Other manufacturing,8019,5035,2984,59,1505
All,2010 Q3,C,Manufacturing,Repair and installation of machinery and equipment,11853,10172,1681,316,1279
All,2010 Q3,B,Mining and quarrying,Quarrying and other mining of non-metal ores,87,81,6,0,3
All,2010 Q3,D,Electricity and gas supply,Electricity and gas supply,7688,6510,1178,24,17
All,2010 Q3,E,"Sewerage, waste management and remediation services",Sewerage,379,241,138,3,43
All,2010 Q3,E,"Sewerage, waste management and remediation services","Waste collection, treatment and disposal; materials recovery",3053,2100,953,45,258
All,2010 Q3,E,"Sewerage, waste management and remediation services",Remediation and other waste management services,74,34,40,0,9
All,2010 Q3,F,Construction,Construction sites (manual workers only),56502,52365,4137,72,1168
All,2010 Q3,F,Construction,Public sector sites,25058,23662,1396,54,420
All,2010 Q3,F,Construction,Public sector building sites,10943,10197,746,0,133
All,2010 Q3,F,Construction,Public sector civil engineering sites,14115,13465,650,54,287
All,2010 Q3,F,Construction,Private sector sites,31444,28703,2741,18,748
All,2010 Q3,F,Construction,Private sector building sites,29571,26963,2608,18,630
All,2010 Q3,F,Construction,Private sector civil engineering sites,1873,1740,133,0,118
All,2010 Q3,G,"Import/export, wholesale and retail trades",Import and export trade,499307,252447,246860,6033,100406
All,2010 Q3,G,"Import/export, wholesale and retail trades",Wholesale,64397,39326,25071,982,15085
All,2010 Q3,G,"Import/export, wholesale and retail trades",Retail trade,242652,98002,144650,5564,60397
All,2010 Q3,H,"Transportation, storage, postal and courier services",Land transport,42236,36435,5801,437,2171
All,2010 Q3,H,"Transportation, storage, postal and courier services",Water transport,10437,6489,3948,99,333
All,2010 Q3,H,"Transportation, storage, postal and courier services",Air transport,21394,8263,13131,205,123
All,2010 Q3,H,"Transportation, storage, postal and courier services",Warehousing and support services for transportation,74311,47564,26747,1038,5775
All,2010 Q3,H,"Transportation, storage, postal and courier services",Postal and courier services,11606,8482,3124,369,676
All,2010 Q3,I,Accommodation and food services,Accommodation services,31948,17353,14595,588,949
All,2010 Q3,I,Accommodation and food services,Food and beverage services,215067,98808,116259,6691,14245
All,2010 Q3,J,Information and communications,Publishing,20428,11222,9206,502,1508
All,2010 Q3,J,Information and communications,"Motion picture, video and television programme production, sound recording and music publishing; Programming and broadcasting",13637,8166,5471,132,1892
All,2010 Q3,J,Information and communications,Telecommunications,17097,11123,5974,464,305
All,2010 Q3,J,Information and communications,Information technology services,33209,24525,8684,1424,5490
All,2010 Q3,J,Information and communications,Information services,4072,2339,1733,80,593
All,2010 Q3,K,Financing and insurance,Financial services (except insurance and pension funding),122430,59556,62874,2341,6521
All,2010 Q3,K,Financing and insurance,Insurance,13036,5074,7962,243,163
All,2010 Q3,K,Financing and insurance,Services auxiliary to financial and insurance services,57620,29050,28570,2631,11795
All,2010 Q3,L,Real estate,Real estate,110241,70877,39364,2973,12367
All,2010 Q3,M,"Professional, scientific and technical services",Legal and accounting services,47426,20978,26448,190,6347
All,2010 Q3,M,"Professional, scientific and technical services",Activities of head offices; management and management consultancy services,28051,13065,14986,324,5696
All,2010 Q3,M,"Professional, scientific and technical services","Architecture and engineering services, technical testing and analysis",33854,22162,11692,384,2918
All,2010 Q3,M,"Professional, scientific and technical services",Scientific research and development,1297,816,481,130,101
All,2010 Q3,M,"Professional, scientific and technical services",Advertising and market research,13812,7375,6437,266,3330
All,2010 Q3,M,"Professional, scientific and technical services","Veterinary services; Other professional, scientific and technical services",18970,10491,8479,295,6658
All,2010 Q3,N,Administrative and support services,Rental and leasing services,2231,1300,931,8,593
All,2010 Q3,N,Administrative and support services,Employment services,12746,5786,6960,451,2153
All,2010 Q3,N,Administrative and support services,"Travel agency, reservation service and related services",19162,8094,11068,267,2328
All,2010 Q3,N,Administrative and support services,Security and investigation services,40101,29466,10635,992,171
All,2010 Q3,N,Administrative and support services,Services to buildings and landscape care,71832,25083,46749,936,1387
All,2010 Q3,N,Administrative and support services,"Office administrative, office support and other business support services",19441,8724,10717,490,4356
All,2010 Q3,P,Education,Education,165184,62339,102845,2534,9260
All,2010 Q3,Q,Human health and social work services,Human health services,92806,25029,67777,1910,6328
All,2010 Q3,Q,Human health and social work services,Residential care services,27179,4150,23029,1155,1133
All,2010 Q3,Q,Human health and social work services,Social work services,29505,7162,22343,661,1812
All,2010 Q3,R,"Arts, entertainment and recreation",Creative and performing arts activities,2412,1432,980,18,884
All,2010 Q3,R,"Arts, entertainment and recreation","Libraries, archives, museums and other cultural activities",507,166,341,11,71
All,2010 Q3,R,"Arts, entertainment and recreation",Amusement parks and theme parks,5987,3381,2606,95,5
All,2010 Q3,R,"Arts, entertainment and recreation",Sports and other entertainment services,36010,19192,16818,2597,1128
All,2010 Q3,S,Other services,Activities of membership organisations,9186,4077,5109,443,997
All,2010 Q3,S,Other services,"Repair of motor vehicles, motorcycles, computers, personal and household goods",17135,14231,2904,365,5756
All,2010 Q4,C,Manufacturing,Manufacture of food products,21629,12086,9543,437,776
All,2010 Q4,C,Manufacturing,Manufacture of beverages,3750,2510,1240,32,29
All,2010 Q4,C,Manufacturing,Manufacture of tobacco products,465,336,129,0,2
All,2010 Q4,C,Manufacturing,Manufacture of textiles,6082,3077,3005,7,807
All,2010 Q4,C,Manufacturing,Manufacture of wearing apparel,13976,5070,8906,40,1155
All,2010 Q4,C,Manufacturing,"Manufacture of leather and related products; Manufacture of wood and of products of wood and cork, articles of straw and plaiting materials (except furniture and toys)",484,325,159,13,145
All,2010 Q4,C,Manufacturing,Manufacture of paper and paper products,1480,1047,433,16,355
All,2010 Q4,C,Manufacturing,Printing and reproduction of recorded media,19432,11860,7572,187,2934
All,2010 Q4,C,Manufacturing,Manufacture of coke and refined petroleum products; Manufacture of chemicals and chemical products,2172,1173,999,7,231
All,2010 Q4,C,Manufacturing,"Manufacture of pharmaceuticals, medicinal chemical and botanical products",3693,1659,2034,84,234
All,2010 Q4,C,Manufacturing,"Manufacture of rubber and plastics products (except furniture, toys, sports goods and stationery)",2729,1742,987,10,458
All,2010 Q4,C,Manufacturing,Manufacture of other non-metallic mineral products,1005,766,239,3,199
All,2010 Q4,C,Manufacturing,Manufacture of basic metals,1146,974,172,30,93
All,2010 Q4,C,Manufacturing,Manufacture of fabricated metal products (except machinery and equipment),3743,2603,1140,10,838
All,2010 Q4,C,Manufacturing,"Manufacture of computer, electronic and optical products",9018,5084,3934,142,388
All,2010 Q4,C,Manufacturing,Manufacture of electrical equipment,2103,1231,872,18,235
All,2010 Q4,C,Manufacturing,Manufacture of machinery and equipment n.e.c.,2608,2153,455,79,500
All,2010 Q4,C,Manufacturing,Body assembly of motor vehicles; Manufacture of other transport equipment,1367,1216,151,77,103
All,2010 Q4,C,Manufacturing,Manufacture of furniture,475,377,98,0,148
All,2010 Q4,C,Manufacturing,Other manufacturing,8139,5076,3063,67,1487
All,2010 Q4,C,Manufacturing,Repair and installation of machinery and equipment,12094,10429,1665,260,1324
All,2010 Q4,B,Mining and quarrying,Quarrying and other mining of non-metal ores,83,76,7,3,3
All,2010 Q4,D,Electricity and gas supply,Electricity and gas supply,7683,6478,1205,29,17
All,2010 Q4,E,"Sewerage, waste management and remediation services",Sewerage,365,212,153,3,41
All,2010 Q4,E,"Sewerage, waste management and remediation services","Waste collection, treatment and disposal; materials recovery",2941,2004,937,28,257
All,2010 Q4,E,"Sewerage, waste management and remediation services",Remediation and other waste management services,86,47,39,0,9
All,2010 Q4,F,Construction,Construction sites (manual workers only),55425,51040,4385,68,1101
All,2010 Q4,F,Construction,Public sector sites,28096,26394,1702,48,436
All,2010 Q4,F,Construction,Public sector building sites,13052,12138,914,0,147
All,2010 Q4,F,Construction,Public sector civil engineering sites,15044,14256,788,48,289
All,2010 Q4,F,Construction,Private sector sites,27329,24646,2683,20,665
All,2010 Q4,F,Construction,Private sector building sites,26327,23701,2626,7,577
All,2010 Q4,F,Construction,Private sector civil engineering sites,1002,945,57,13,88
All,2010 Q4,G,"Import/export, wholesale and retail trades",Import and export trade,500817,257463,243354,5726,101575
All,2010 Q4,G,"Import/export, wholesale and retail trades",Wholesale,64064,39606,24458,761,14955
All,2010 Q4,G,"Import/export, wholesale and retail trades",Retail trade,248349,98802,149547,4936,61713
All,2010 Q4,H,"Transportation, storage, postal and courier services",Land transport,42533,36935,5598,361,2217
All,2010 Q4,H,"Transportation, storage, postal and courier services",Water transport,10675,6709,3966,117,373
All,2010 Q4,H,"Transportation, storage, postal and courier services",Air transport,21599,8441,13158,167,123
All,2010 Q4,H,"Transportation, storage, postal and courier services",Warehousing and support services for transportation,74951,46679,28272,1177,6097
All,2010 Q4,H,"Transportation, storage, postal and courier services",Postal and courier services,11786,8734,3052,264,674
All,2010 Q4,I,Accommodation and food services,Accommodation services,33386,18082,15304,734,978
All,2010 Q4,I,Accommodation and food services,Food and beverage services,221902,107321,114581,7080,14933
All,2010 Q4,J,Information and communications,Publishing,20364,11163,9201,449,1534
All,2010 Q4,J,Information and communications,"Motion picture, video and television programme production, sound recording and music publishing; Programming and broadcasting",13846,8598,5248,169,2000
All,2010 Q4,J,Information and communications,Telecommunications,17548,11485,6063,526,318
All,2010 Q4,J,Information and communications,Information technology services,32860,24658,8202,830,5491
All,2010 Q4,J,Information and communications,Information services,4276,2306,1970,110,615
All,2010 Q4,K,Financing and insurance,Financial services (except insurance and pension funding),123703,59547,64156,2138,6659
All,2010 Q4,K,Financing and insurance,Insurance,13264,5107,8157,233,164
All,2010 Q4,K,Financing and insurance,Services auxiliary to financial and insurance services,59446,29578,29868,2058,12203
All,2010 Q4,L,Real estate,Real estate,112542,70131,42411,2603,12942
All,2010 Q4,M,"Professional, scientific and technical services",Legal and accounting services,47108,21534,25574,479,6437
All,2010 Q4,M,"Professional, scientific and technical services",Activities of head offices; management and management consultancy services,29057,14078,14979,570,5908
All,2010 Q4,M,"Professional, scientific and technical services","Architecture and engineering services, technical testing and analysis",34556,22588,11968,581,2929
All,2010 Q4,M,"Professional, scientific and technical services",Scientific research and development,1408,864,544,156,95
All,2010 Q4,M,"Professional, scientific and technical services",Advertising and market research,13573,7617,5956,276,3333
All,2010 Q4,M,"Professional, scientific and technical services","Veterinary services; Other professional, scientific and technical services",19095,10915,8180,421,6880
All,2010 Q4,N,Administrative and support services,Rental and leasing services,2212,1203,1009,24,588
All,2010 Q4,N,Administrative and support services,Employment services,13301,5772,7529,521,2241
All,2010 Q4,N,Administrative and support services,"Travel agency, reservation service and related services",19345,7564,11781,410,2386
All,2010 Q4,N,Administrative and support services,Security and investigation services,40617,29399,11218,973,172
All,2010 Q4,N,Administrative and support services,Services to buildings and landscape care,74134,25970,48164,786,1421
All,2010 Q4,N,Administrative and support services,"Office administrative, office support and other business support services",19938,9672,10266,426,4509
All,2010 Q4,P,Education,Education,165601,61668,103933,2576,9560
All,2010 Q4,Q,Human health and social work services,Human health services,94226,25115,69111,1448,6619
All,2010 Q4,Q,Human health and social work services,Residential care services,27348,3570,23778,1113,1139
All,2010 Q4,Q,Human health and social work services,Social work services,30066,6881,23185,353,1836
All,2010 Q4,R,"Arts, entertainment and recreation",Creative and performing arts activities,2561,1413,1148,49,923
All,2010 Q4,R,"Arts, entertainment and recreation","Libraries, archives, museums and other cultural activities",567,206,361,24,73
All,2010 Q4,R,"Arts, entertainment and recreation",Amusement parks and theme parks,4545,2567,1978,112,5
All,2010 Q4,R,"Arts, entertainment and recreation",Sports and other entertainment services,36741,19072,17669,2067,1198
All,2010 Q4,S,Other services,Activities of membership organisations,9162,4103,5059,153,1059
All,2010 Q4,S,Other services,"Repair of motor vehicles, motorcycles, computers, personal and household goods",17474,14682,2792,387,5921
All,2010 Q4,S,Other services,Other personal services,44521,14502,30019,2095,10685
All,2011 Q1,C,Manufacturing,Manufacture of food products,21932,11546,10386,671,813
All,2011 Q1,C,Manufacturing,Manufacture of beverages,3630,2410,1220,46,29
All,2011 Q1,C,Manufacturing,Manufacture of tobacco products,465,336,129,0,2
All,2011 Q1,C,Manufacturing,Manufacture of textiles,5770,3223,2547,58,783
All,2011 Q1,C,Manufacturing,Manufacture of wearing apparel,13246,4760,8486,13,1107
All,2011 Q1,C,Manufacturing,"Manufacture of leather and related products; Manufacture of wood and of products of wood and cork, articles of straw and plaiting materials (except furniture and toys)",502,332,170,14,140
All,2011 Q1,C,Manufacturing,Manufacture of paper and paper products,1496,1130,366,1,350
All,2011 Q1,C,Manufacturing,Printing and reproduction of recorded media,19461,13187,6274,128,2914
All,2011 Q1,C,Manufacturing,Manufacture of coke and refined petroleum products; Manufacture of chemicals and chemical products,2154,1385,769,25,232
All,2011 Q1,C,Manufacturing,"Manufacture of pharmaceuticals, medicinal chemical and botanical products",3700,1475,2225,129,234
All,2011 Q1,C,Manufacturing,"Manufacture of rubber and plastics products (except furniture, toys, sports goods and stationery)",2529,1572,957,10,434
All,2011 Q1,C,Manufacturing,Manufacture of other non-metallic mineral products,993,838,155,8,198
All,2011 Q1,C,Manufacturing,Manufacture of basic metals,1100,890,210,32,92
All,2011 Q1,C,Manufacturing,Manufacture of fabricated metal products (except machinery and equipment),3750,2693,1057,8,841
All,2011 Q1,C,Manufacturing,"Manufacture of computer, electronic and optical products",7915,4487,3428,61,381
All,2011 Q1,C,Manufacturing,Manufacture of electrical equipment,2077,1335,742,21,240
All,2011 Q1,C,Manufacturing,Manufacture of machinery and equipment n.e.c.,2602,2143,459,75,493
All,2011 Q1,C,Manufacturing,Body assembly of motor vehicles; Manufacture of other transport equipment,1422,1262,160,70,104
All,2011 Q1,C,Manufacturing,Manufacture of furniture,450,368,82,0,143
All,2011 Q1,C,Manufacturing,Other manufacturing,7763,4726,3037,154,1461
All,2011 Q1,C,Manufacturing,Repair and installation of machinery and equipment,12178,10455,1723,805,1290
All,2011 Q1,B,Mining and quarrying,Quarrying and other mining of non-metal ores,66,63,3,0,3
All,2011 Q1,D,Electricity and gas supply,Electricity and gas supply,7633,6461,1172,27,16
All,2011 Q1,E,"Sewerage, waste management and remediation services",Sewerage,349,265,84,2,38
All,2011 Q1,E,"Sewerage, waste management and remediation services","Waste collection, treatment and disposal; materials recovery",2842,2033,809,47,274
All,2011 Q1,E,"Sewerage, waste management and remediation services",Remediation and other waste management services,80,44,36,0,9
All,2011 Q1,F,Construction,Construction sites (manual workers only),58807,54338,4469,149,1053
All,2011 Q1,F,Construction,Public sector sites,30962,29302,1660,99,466
All,2011 Q1,F,Construction,Public sector building sites,14077,13185,892,0,161
All,2011 Q1,F,Construction,Public sector civil engineering sites,16885,16117,768,99,305
All,2011 Q1,F,Construction,Private sector sites,27845,25036,2809,50,587
All,2011 Q1,F,Construction,Private sector building sites,26777,24054,2723,50,509
All,2011 Q1,F,Construction,Private sector civil engineering sites,1068,982,86,0,78
All,2011 Q1,G,"Import/export, wholesale and retail trades",Import and export trade,500568,257731,242837,7311,102648
All,2011 Q1,G,"Import/export, wholesale and retail trades",Wholesale,64387,39205,25182,983,15157
All,2011 Q1,G,"Import/export, wholesale and retail trades",Retail trade,251348,98349,152999,6028,63151
All,2011 Q1,H,"Transportation, storage, postal and courier services",Land transport,42394,36703,5691,573,2246
All,2011 Q1,H,"Transportation, storage, postal and courier services",Water transport,10228,6659,3569,125,360
All,2011 Q1,H,"Transportation, storage, postal and courier services",Air transport,21676,8283,13393,148,119
All,2011 Q1,H,"Transportation, storage, postal and courier services",Warehousing and support services for transportation,75225,47171,28054,1320,6236
All,2011 Q1,H,"Transportation, storage, postal and courier services",Postal and courier services,12530,9020,3510,369,700
All,2011 Q1,I,Accommodation and food services,Accommodation services,33052,17670,15382,987,992
All,2011 Q1,I,Accommodation and food services,Food and beverage services,229920,106765,123155,6746,15605
All,2011 Q1,J,Information and communications,Publishing,20598,11423,9175,431,1601
All,2011 Q1,J,Information and communications,"Motion picture, video and television programme production, sound recording and music publishing; Programming and broadcasting",13722,8319,5403,214,2044
All,2011 Q1,J,Information and communications,Telecommunications,17039,11090,5949,555,306
All,2011 Q1,J,Information and communications,Information technology services,33568,25776,7792,1311,5755
All,2011 Q1,J,Information and communications,Information services,4374,2372,2002,162,655
All,2011 Q1,K,Financing and insurance,Financial services (except insurance and pension funding),124793,60059,64734,2025,6945
All,2011 Q1,K,Financing and insurance,Insurance,13019,4945,8074,299,157
All,2011 Q1,K,Financing and insurance,Services auxiliary to financial and insurance services,60831,30748,30083,1593,12354
All,2011 Q1,L,Real estate,Real estate,116784,74953,41831,3147,13497
All,2011 Q1,M,"Professional, scientific and technical services",Legal and accounting services,47149,21116,26033,574,6533
All,2011 Q1,M,"Professional, scientific and technical services",Activities of head offices; management and management consultancy services,29004,13805,15199,615,6068
All,2011 Q1,M,"Professional, scientific and technical services","Architecture and engineering services, technical testing and analysis",34888,23288,11600,882,2960
All,2011 Q1,M,"Professional, scientific and technical services",Scientific research and development,1458,952,506,148,110
All,2011 Q1,M,"Professional, scientific and technical services",Advertising and market research,13561,7427,6134,243,3380
All,2011 Q1,M,"Professional, scientific and technical services","Veterinary services; Other professional, scientific and technical services",19110,10958,8152,666,7070
All,2011 Q1,N,Administrative and support services,Rental and leasing services,2271,1345,926,39,585
All,2011 Q1,N,Administrative and support services,Employment services,13752,6062,7690,528,2265
All,2011 Q1,N,Administrative and support services,"Travel agency, reservation service and related services",19692,8046,11646,437,2483
All,2011 Q1,N,Administrative and support services,Security and investigation services,40872,29666,11206,1655,173
All,2011 Q1,N,Administrative and support services,Services to buildings and landscape care,75949,27385,48564,845,1487
All,2011 Q1,N,Administrative and support services,"Office administrative, office support and other business support services",19739,10151,9588,394,4742
All,2011 Q1,P,Education,Education,167402,62588,104814,2673,9902
All,2011 Q1,Q,Human health and social work services,Human health services,95078,25760,69318,3358,6716
All,2011 Q1,Q,Human health and social work services,Residential care services,27415,4152,23263,1444,1145
All,2011 Q1,Q,Human health and social work services,Social work services,29913,6797,23116,785,1890
All,2011 Q1,R,"Arts, entertainment and recreation",Creative and performing arts activities,2712,1381,1331,74,973
All,2011 Q1,R,"Arts, entertainment and recreation","Libraries, archives, museums and other cultural activities",554,207,347,7,72
All,2011 Q1,R,"Arts, entertainment and recreation",Amusement parks and theme parks,4501,2530,1971,136,6
All,2011 Q1,R,"Arts, entertainment and recreation",Sports and other entertainment services,36424,19134,17290,2126,1251
All,2011 Q1,S,Other services,Activities of membership organisations,9292,4158,5134,162,1062
All,2011 Q1,S,Other services,"Repair of motor vehicles, motorcycles, computers, personal and household goods",17805,14568,3237,442,6049
All,2011 Q1,S,Other services,Other personal services,45143,14203,30940,2042,10999
All,2011 Q2,C,Manufacturing,Manufacture of food products,21686,11010,10676,502,841
All,2011 Q2,C,Manufacturing,Manufacture of beverages,3705,2407,1298,49,29
All,2011 Q2,C,Manufacturing,Manufacture of tobacco products,463,332,131,0,2
All,2011 Q2,C,Manufacturing,Manufacture of textiles,5842,3258,2584,22,786
All,2011 Q2,C,Manufacturing,Manufacture of wearing apparel,12510,4964,7546,38,1088
All,2011 Q2,C,Manufacturing,"Manufacture of leather and related products; Manufacture of wood and of products of wood and cork, articles of straw and plaiting materials (except furniture and toys)",542,370,172,18,149
All,2011 Q2,C,Manufacturing,Manufacture of paper and paper products,1423,1003,420,0,346
All,2011 Q2,C,Manufacturing,Printing and reproduction of recorded media,18785,12296,6489,168,2885
All,2011 Q2,C,Manufacturing,Manufacture of coke and refined petroleum products; Manufacture of chemicals and chemical products,2190,1341,849,27,226
All,2011 Q2,C,Manufacturing,"Manufacture of pharmaceuticals, medicinal chemical and botanical products",3995,1560,2435,127,240
All,2011 Q2,C,Manufacturing,"Manufacture of rubber and plastics products (except furniture, toys, sports goods and stationery)",2487,1705,782,6,432
All,2011 Q2,C,Manufacturing,Manufacture of other non-metallic mineral products,1049,860,189,17,212
All,2011 Q2,C,Manufacturing,Manufacture of basic metals,1134,913,221,44,89
All,2011 Q2,C,Manufacturing,Manufacture of fabricated metal products (except machinery and equipment),3763,2821,942,1,870
All,2011 Q2,C,Manufacturing,"Manufacture of computer, electronic and optical products",7631,4461,3170,80,382
All,2011 Q2,C,Manufacturing,Manufacture of electrical equipment,2122,1533,589,12,243
All,2011 Q2,C,Manufacturing,Manufacture of machinery and equipment n.e.c.,2626,2292,334,28,478
All,2011 Q2,C,Manufacturing,Body assembly of motor vehicles; Manufacture of other transport equipment,1515,1356,159,91,103
All,2011 Q2,C,Manufacturing,Manufacture of furniture,481,345,136,0,148
All,2011 Q2,C,Manufacturing,Other manufacturing,7770,4717,3053,130,1462
All,2011 Q2,C,Manufacturing,Repair and installation of machinery and equipment,12097,10305,1792,773,1285
All,2011 Q2,B,Mining and quarrying,Quarrying and other mining of non-metal ores,69,63,6,0,2
All,2011 Q2,D,Electricity and gas supply,Electricity and gas supply,7618,6418,1200,39,15
All,2011 Q2,E,"Sewerage, waste management and remediation services",Sewerage,317,218,99,2,36
All,2011 Q2,E,"Sewerage, waste management and remediation services","Waste collection, treatment and disposal; materials recovery",3013,2007,1006,49,267
All,2011 Q2,E,"Sewerage, waste management and remediation services",Remediation and other waste management services,72,31,41,0,8
All,2011 Q2,F,Construction,Construction sites (manual workers only),58609,54115,4494,302,1062
All,2011 Q2,F,Construction,Public sector sites,28685,27046,1639,209,435
All,2011 Q2,F,Construction,Public sector building sites,13139,12214,925,5,152
All,2011 Q2,F,Construction,Public sector civil engineering sites,15546,14832,714,204,283
All,2011 Q2,F,Construction,Private sector sites,29924,27069,2855,93,627
All,2011 Q2,F,Construction,Private sector building sites,28704,25921,2783,88,539
All,2011 Q2,F,Construction,Private sector civil engineering sites,1220,1148,72,5,88
All,2011 Q2,G,"Import/export, wholesale and retail trades",Import and export trade,496794,250814,245980,6973,102420
All,2011 Q2,G,"Import/export, wholesale and retail trades",Wholesale,64005,38829,25176,1294,15097
All,2011 Q2,G,"Import/export, wholesale and retail trades",Retail trade,252001,101966,150035,5197,63318
All,2011 Q2,H,"Transportation, storage, postal and courier services",Land transport,42468,37077,5391,727,2242
All,2011 Q2,H,"Transportation, storage, postal and courier services",Water transport,10597,6632,3965,79,375
All,2011 Q2,H,"Transportation, storage, postal and courier services",Air transport,22054,8253,13801,171,124
All,2011 Q2,H,"Transportation, storage, postal and courier services",Warehousing and support services for transportation,75620,47397,28223,1765,6296
All,2011 Q2,H,"Transportation, storage, postal and courier services",Postal and courier services,12347,8911,3436,269,704
All,2011 Q2,I,Accommodation and food services,Accommodation services,33963,18449,15514,838,994
All,2011 Q2,I,Accommodation and food services,Food and beverage services,232132,108017,124115,7281,15807
All,2011 Q2,J,Information and communications,Publishing,20405,11381,9024,257,1618
All,2011 Q2,J,Information and communications,"Motion picture, video and television programme production, sound recording and music publishing; Programming and broadcasting",13849,8055,5794,214,2044
All,2011 Q2,J,Information and communications,Telecommunications,17804,11739,6065,548,323
All,2011 Q2,J,Information and communications,Information technology services,34484,25306,9178,1077,5817
All,2011 Q2,J,Information and communications,Information services,4517,2523,1994,96,675
All,2011 Q2,K,Financing and insurance,Financial services (except insurance and pension funding),127882,61199,66683,2489,6975
All,2011 Q2,K,Financing and insurance,Insurance,12857,4864,7993,479,154
All,2011 Q2,K,Financing and insurance,Services auxiliary to financial and insurance services,62096,31127,30969,1898,12526
All,2011 Q2,L,Real estate,Real estate,118781,74876,43905,3128,13713
All,2011 Q2,M,"Professional, scientific and technical services",Legal and accounting services,47749,21375,26374,753,6560
All,2011 Q2,M,"Professional, scientific and technical services",Activities of head offices; management and management consultancy services,29101,14103,14998,557,6161
All,2011 Q2,M,"Professional, scientific and technical services","Architecture and engineering services, technical testing and analysis",35366,23191,12175,752,2960
All,2011 Q2,M,"Professional, scientific and technical services",Scientific research and development,1544,842,702,121,110
All,2011 Q2,M,"Professional, scientific and technical services",Advertising and market research,13657,7554,6103,342,3371
All,2011 Q2,M,"Professional, scientific and technical services","Veterinary services; Other professional, scientific and technical services",19412,11096,8316,496,7194
All,2011 Q2,N,Administrative and support services,Rental and leasing services,2357,1288,1069,110,584
All,2011 Q2,N,Administrative and support services,Employment services,14343,6515,7828,414,2252
All,2011 Q2,N,Administrative and support services,"Travel agency, reservation service and related services",19842,7977,11865,571,2490
All,2011 Q2,N,Administrative and support services,Security and investigation services,40505,29643,10862,1070,175
All,2011 Q2,N,Administrative and support services,Services to buildings and landscape care,76956,27252,49704,943,1509
All,2011 Q2,N,Administrative and support services,"Office administrative, office support and other business support services",19880,9492,10388,442,4789
All,2011 Q2,P,Education,Education,167320,60658,106662,2930,10203
All,2011 Q2,Q,Human health and social work services,Human health services,96212,26096,70116,3763,6761
All,2011 Q2,Q,Human health and social work services,Residential care services,27405,4220,23185,1404,1160
All,2011 Q2,Q,Human health and social work services,Social work services,30238,6438,23800,772,1894
All,2011 Q2,R,"Arts, entertainment and recreation",Creative and performing arts activities,2707,1553,1154,43,982
All,2011 Q2,R,"Arts, entertainment and recreation","Libraries, archives, museums and other cultural activities",558,194,364,13,75
All,2011 Q2,R,"Arts, entertainment and recreation",Amusement parks and theme parks,5034,2847,2187,135,6
All,2011 Q2,R,"Arts, entertainment and recreation",Sports and other entertainment services,36994,19362,17632,788,1256
All,2011 Q2,S,Other services,Activities of membership organisations,9538,4105,5433,167,1074
All,2011 Q2,S,Other services,"Repair of motor vehicles, motorcycles, computers, personal and household goods",17758,14617,3141,525,6122
All,2011 Q2,S,Other services,Other personal services,44970,13605,31365,2196,11057
All,2011 Q3,C,Manufacturing,Manufacture of food products,21572,10813,10759,646,826
All,2011 Q3,C,Manufacturing,Manufacture of beverages,3663,2414,1249,55,26
All,2011 Q3,C,Manufacturing,Manufacture of tobacco products,483,348,135,0,2
All,2011 Q3,C,Manufacturing,Manufacture of textiles,5806,3088,2718,34,780
All,2011 Q3,C,Manufacturing,Manufacture of wearing apparel,12081,4480,7601,19,1066
All,2011 Q3,C,Manufacturing,"Manufacture of leather and related products; Manufacture of wood and of products of wood and cork, articles of straw and plaiting materials (except furniture and toys)",491,341,150,8,141
All,2011 Q3,C,Manufacturing,Manufacture of paper and paper products,1319,913,406,20,345
All,2011 Q3,C,Manufacturing,Printing and reproduction of recorded media,18239,12216,6023,217,2815
All,2011 Q3,C,Manufacturing,Manufacture of coke and refined petroleum products; Manufacture of chemicals and chemical products,2162,1358,804,8,225
All,2011 Q3,C,Manufacturing,"Manufacture of pharmaceuticals, medicinal chemical and botanical products",4131,1694,2437,140,255
All,2011 Q3,C,Manufacturing,"Manufacture of rubber and plastics products (except furniture, toys, sports goods and stationery)",2379,1563,816,30,422
All,2011 Q3,C,Manufacturing,Manufacture of other non-metallic mineral products,1019,875,144,14,214
All,2011 Q3,C,Manufacturing,Manufacture of basic metals,1131,952,179,13,87
All,2011 Q3,C,Manufacturing,Manufacture of fabricated metal products (except machinery and equipment),3634,2467,1167,18,859
All,2011 Q3,C,Manufacturing,"Manufacture of computer, electronic and optical products",7257,4269,2988,38,378
All,2011 Q3,C,Manufacturing,Manufacture of electrical equipment,2056,1140,916,25,239
All,2011 Q3,C,Manufacturing,Manufacture of machinery and equipment n.e.c.,2597,2159,438,67,461
All,2011 Q3,C,Manufacturing,Body assembly of motor vehicles; Manufacture of other transport equipment,1496,1312,184,62,101
All,2011 Q3,C,Manufacturing,Manufacture of furniture,471,411,60,0,147
All,2011 Q3,C,Manufacturing,Other manufacturing,7574,4725,2849,195,1438
All,2011 Q3,C,Manufacturing,Repair and installation of machinery and equipment,11973,10371,1602,670,1282
All,2011 Q3,B,Mining and quarrying,Quarrying and other mining of non-metal ores,71,65,6,0,2
All,2011 Q3,D,Electricity and gas supply,Electricity and gas supply,7683,6466,1217,28,15
All,2011 Q3,E,"Sewerage, waste management and remediation services",Sewerage,310,194,116,2,35
All,2011 Q3,E,"Sewerage, waste management and remediation services","Waste collection, treatment and disposal; materials recovery",2916,1961,955,65,264
All,2011 Q3,E,"Sewerage, waste management and remediation services",Remediation and other waste management services,64,30,34,0,8
All,2011 Q3,F,Construction,Construction sites (manual workers only),63728,58322,5406,534,1143
All,2011 Q3,F,Construction,Public sector sites,28226,26527,1699,360,453
All,2011 Q3,F,Construction,Public sector building sites,10947,10097,850,5,157
All,2011 Q3,F,Construction,Public sector civil engineering sites,17279,16430,849,355,296
All,2011 Q3,F,Construction,Private sector sites,35502,31795,3707,174,690
All,2011 Q3,F,Construction,Private sector building sites,34248,30621,3627,174,605
All,2011 Q3,F,Construction,Private sector civil engineering sites,1254,1174,80,0,85
All,2011 Q3,G,"Import/export, wholesale and retail trades",Import and export trade,499640,253330,246310,6696,102672
All,2011 Q3,G,"Import/export, wholesale and retail trades",Wholesale,64703,38646,26057,1047,15187
All,2011 Q3,G,"Import/export, wholesale and retail trades",Retail trade,252935,100648,152287,6135,63482
All,2011 Q3,H,"Transportation, storage, postal and courier services",Land transport,42905,36729,6176,502,2258
All,2011 Q3,H,"Transportation, storage, postal and courier services",Water transport,10549,6825,3724,19,384
All,2011 Q3,H,"Transportation, storage, postal and courier services",Air transport,22376,8462,13914,175,125
All,2011 Q3,H,"Transportation, storage, postal and courier services",Warehousing and support services for transportation,75626,47220,28406,1485,6290
All,2011 Q3,H,"Transportation, storage, postal and courier services",Postal and courier services,12319,9065,3254,250,687
All,2011 Q3,I,Accommodation and food services,Accommodation services,34228,18636,15592,700,1012
All,2011 Q3,I,Accommodation and food services,Food and beverage services,232085,109191,122894,7288,15805
All,2011 Q3,J,Information and communications,Publishing,20621,10823,9798,254,1603
All,2011 Q3,J,Information and communications,"Motion picture, video and television programme production, sound recording and music publishing; Programming and broadcasting",13883,8397,5486,134,2078
All,2011 Q3,J,Information and communications,Telecommunications,17866,11411,6455,427,315
All,2011 Q3,J,Information and communications,Information technology services,34774,25981,8793,1305,5937
All,2011 Q3,J,Information and communications,Information services,4519,2544,1975,120,684
All,2011 Q3,K,Financing and insurance,Financial services (except insurance and pension funding),131019,63642,67377,2254,7177
All,2011 Q3,K,Financing and insurance,Insurance,13153,5145,8008,292,152
All,2011 Q3,K,Financing and insurance,Services auxiliary to financial and insurance services,62463,31714,30749,2209,12710
All,2011 Q3,L,Real estate,Real estate,119995,75936,44059,2884,13911
All,2011 Q3,M,"Professional, scientific and technical services",Legal and accounting services,48218,22021,26197,561,6623
All,2011 Q3,M,"Professional, scientific and technical services",Activities of head offices; management and management consultancy services,29786,14843,14943,457,6313
All,2011 Q3,M,"Professional, scientific and technical services","Architecture and engineering services, technical testing and analysis",36045,23797,12248,872,2972
All,2011 Q3,M,"Professional, scientific and technical services",Scientific research and development,1583,1079,504,142,124
All,2011 Q3,M,"Professional, scientific and technical services",Advertising and market research,13487,7667,5820,119,3401
All,2011 Q3,M,"Professional, scientific and technical services","Veterinary services; Other professional, scientific and technical services",19861,11478,8383,325,7337
All,2011 Q3,N,Administrative and support services,Rental and leasing services,2484,1403,1081,29,639
All,2011 Q3,N,Administrative and support services,Employment services,15247,6766,8481,559,2337
All,2011 Q3,N,Administrative and support services,"Travel agency, reservation service and related services",19834,7614,12220,565,2501
All,2011 Q3,N,Administrative and support services,Security and investigation services,41930,30248,11682,1556,183
All,2011 Q3,N,Administrative and support services,Services to buildings and landscape care,77339,26897,50442,927,1526
All,2011 Q3,N,Administrative and support services,"Office administrative, office support and other business support services",20073,9870,10203,562,4802
All,2011 Q3,P,Education,Education,168274,62489,105785,3406,10383
All,2011 Q3,Q,Human health and social work services,Human health services,96622,25883,70739,3724,6779
All,2011 Q3,Q,Human health and social work services,Residential care services,27367,4544,22823,1379,1153
All,2011 Q3,Q,Human health and social work services,Social work services,30122,7092,23030,689,1926
All,2011 Q3,R,"Arts, entertainment and recreation",Creative and performing arts activities,2775,1547,1228,34,1026
All,2011 Q3,R,"Arts, entertainment and recreation","Libraries, archives, museums and other cultural activities",544,188,356,13,78
All,2011 Q3,R,"Arts, entertainment and recreation",Amusement parks and theme parks,5729,3309,2420,211,6
All,2011 Q3,R,"Arts, entertainment and recreation",Sports and other entertainment services,36810,18890,17920,1545,1257
All,2011 Q3,S,Other services,Activities of membership organisations,9682,4200,5482,158,1082
All,2011 Q3,S,Other services,"Repair of motor vehicles, motorcycles, computers, personal and household goods",17564,14717,2847,523,6104
All,2011 Q3,S,Other services,Other personal services,45154,14568,30586,2219,11136
All,2011 Q4,C,Manufacturing,Manufacture of food products,21645,11143,10502,679,830
All,2011 Q4,C,Manufacturing,Manufacture of beverages,3665,2717,948,44,26
All,2011 Q4,C,Manufacturing,Manufacture of tobacco products,493,347,146,0,2
All,2011 Q4,C,Manufacturing,Manufacture of textiles,5787,3440,2347,10,766
All,2011 Q4,C,Manufacturing,Manufacture of wearing apparel,11375,4710,6665,38,1034
All,2011 Q4,C,Manufacturing,"Manufacture of leather and related products; Manufacture of wood and of products of wood and cork, articles of straw and plaiting materials (except furniture and toys)",504,346,158,15,151
All,2011 Q4,C,Manufacturing,Manufacture of paper and paper products,1261,817,444,1,337
All,2011 Q4,C,Manufacturing,Printing and reproduction of recorded media,17983,12263,5720,198,2793
All,2011 Q4,C,Manufacturing,Manufacture of coke and refined petroleum products; Manufacture of chemicals and chemical products,2101,1135,966,13,224
All,2011 Q4,C,Manufacturing,"Manufacture of pharmaceuticals, medicinal chemical and botanical products",4205,1600,2605,77,252
All,2011 Q4,C,Manufacturing,"Manufacture of rubber and plastics products (except furniture, toys, sports goods and stationery)",2410,1672,738,16,427
All,2011 Q4,C,Manufacturing,Manufacture of other non-metallic mineral products,1063,801,262,13,208
All,2011 Q4,C,Manufacturing,Manufacture of basic metals,1174,1006,168,9,90
All,2011 Q4,C,Manufacturing,Manufacture of fabricated metal products (except machinery and equipment),3579,2685,894,37,855
All,2011 Q4,C,Manufacturing,"Manufacture of computer, electronic and optical products",7087,4191,2896,26,378
All,2011 Q4,C,Manufacturing,Manufacture of electrical equipment,1961,1037,924,37,234
All,2011 Q4,C,Manufacturing,Manufacture of machinery and equipment n.e.c.,2576,2012,564,29,461
All,2011 Q4,C,Manufacturing,Body assembly of motor vehicles; Manufacture of other transport equipment,1501,1324,177,70,100
All,2011 Q4,C,Manufacturing,Manufacture of furniture,464,371,93,0,136
All,2011 Q4,C,Manufacturing,Other manufacturing,7518,4648,2870,123,1433
All,2011 Q4,C,Manufacturing,Repair and installation of machinery and equipment,12027,10275,1752,468,1274
All,2011 Q4,B,Mining and quarrying,Quarrying and other mining of non-metal ores,71,65,6,0,2
All,2011 Q4,D,Electricity and gas supply,Electricity and gas supply,7605,6418,1187,33,14
All,2011 Q4,E,"Sewerage, waste management and remediation services",Sewerage,295,248,47,6,32
All,2011 Q4,E,"Sewerage, waste management and remediation services","Waste collection, treatment and disposal; materials recovery",2649,1786,863,67,273
All,2011 Q4,E,"Sewerage, waste management and remediation services",Remediation and other waste management services,67,35,32,0,7
All,2011 Q4,F,Construction,Construction sites (manual workers only),69395,63402,5993,330,1172
All,2011 Q4,F,Construction,Public sector sites,30547,28536,2011,141,474
All,2011 Q4,F,Construction,Public sector building sites,11177,10362,815,6,160
All,2011 Q4,F,Construction,Public sector civil engineering sites,19370,18174,1196,135,314
All,2011 Q4,F,Construction,Private sector sites,38848,34866,3982,189,698
All,2011 Q4,F,Construction,Private sector building sites,37391,33518,3873,180,597
All,2011 Q4,F,Construction,Private sector civil engineering sites,1457,1348,109,9,101
All,2011 Q4,G,"Import/export, wholesale and retail trades",Import and export trade,495847,254775,241072,6249,102273
All,2011 Q4,G,"Import/export, wholesale and retail trades",Wholesale,63763,38818,24945,818,14996
All,2011 Q4,G,"Import/export, wholesale and retail trades",Retail trade,254974,99271,155703,6277,63277
All,2011 Q4,H,"Transportation, storage, postal and courier services",Land transport,42610,36655,5955,713,2251
All,2011 Q4,H,"Transportation, storage, postal and courier services",Water transport,10749,6861,3888,29,369
All,2011 Q4,H,"Transportation, storage, postal and courier services",Air transport,23322,8797,14525,209,130
All,2011 Q4,H,"Transportation, storage, postal and courier services",Warehousing and support services for transportation,76094,46939,29155,1308,6343
All,2011 Q4,H,"Transportation, storage, postal and courier services",Postal and courier services,12699,9154,3545,248,676
All,2011 Q4,I,Accommodation and food services,Accommodation services,34982,18811,16171,777,1006
All,2011 Q4,I,Accommodation and food services,Food and beverage services,231333,107525,123808,8215,15757
All,2011 Q4,J,Information and communications,Publishing,20622,11743,8879,260,1596
All,2011 Q4,J,Information and communications,"Motion picture, video and television programme production, sound recording and music publishing; Programming and broadcasting",14124,8800,5324,156,2097
All,2011 Q4,J,Information and communications,Telecommunications,18087,11857,6230,386,307
All,2011 Q4,J,Information and communications,Information technology services,35729,26424,9305,1308,6061
All,2011 Q4,J,Information and communications,Information services,4706,2513,2193,112,695
All,2011 Q4,K,Financing and insurance,Financial services (except insurance and pension funding),130330,62772,67558,1594,7495
All,2011 Q4,K,Financing and insurance,Insurance,13523,5224,8299,304,153
All,2011 Q4,K,Financing and insurance,Services auxiliary to financial and insurance services,63471,32664,30807,2270,12962
All,2011 Q4,L,Real estate,Real estate,122252,76208,46044,2504,14250
All,2011 Q4,M,"Professional, scientific and technical services",Legal and accounting services,48942,21848,27094,568,6712
All,2011 Q4,M,"Professional, scientific and technical services",Activities of head offices; management and management consultancy services,30301,14792,15509,688,6424
All,2011 Q4,M,"Professional, scientific and technical services","Architecture and engineering services, technical testing and analysis",36850,24598,12252,654,2965
All,2011 Q4,M,"Professional, scientific and technical services",Scientific research and development,1569,973,596,139,126
All,2011 Q4,M,"Professional, scientific and technical services",Advertising and market research,13512,7114,6398,119,3432
All,2011 Q4,M,"Professional, scientific and technical services","Veterinary services; Other professional, scientific and technical services",20084,10897,9187,518,7424
All,2011 Q4,N,Administrative and support services,Rental and leasing services,2619,1571,1048,55,627
All,2011 Q4,N,Administrative and support services,Employment services,15677,6850,8827,420,2392
All,2011 Q4,N,Administrative and support services,"Travel agency, reservation service and related services",20038,7860,12178,533,2536
All,2011 Q4,N,Administrative and support services,Security and investigation services,41182,29454,11728,1406,177
All,2011 Q4,N,Administrative and support services,Services to buildings and landscape care,78005,27849,50156,861,1542
All,2011 Q4,N,Administrative and support services,"Office administrative, office support and other business support services",20014,9649,10365,621,4800
All,2011 Q4,P,Education,Education,169337,63667,105670,2802,10458
All,2011 Q4,Q,Human health and social work services,Human health services,98501,26299,72202,2115,6889
All,2011 Q4,Q,Human health and social work services,Residential care services,26994,4421,22573,1274,1151
All,2011 Q4,Q,Human health and social work services,Social work services,30137,7176,22961,836,1922
All,2011 Q4,R,"Arts, entertainment and recreation",Creative and performing arts activities,2910,1662,1248,66,1105
All,2011 Q4,R,"Arts, entertainment and recreation","Libraries, archives, museums and other cultural activities",569,190,379,13,85
All,2011 Q4,R,"Arts, entertainment and recreation",Amusement parks and theme parks,4874,2660,2214,172,6
All,2011 Q4,R,"Arts, entertainment and recreation",Sports and other entertainment services,36161,19461,16700,2261,1305
All,2011 Q4,S,Other services,Activities of membership organisations,9557,4048,5509,220,1101
All,2011 Q4,S,Other services,"Repair of motor vehicles, motorcycles, computers, personal and household goods",17635,14412,3223,363,6095
All,2011 Q4,S,Other services,Other personal services,45030,13843,31187,2323,11077
All,2012 Q1,C,Manufacturing,Manufacture of food products,21767,10962,10805,561,854
All,2012 Q1,C,Manufacturing,Manufacture of beverages,3670,2685,985,90,28
All,2012 Q1,C,Manufacturing,Manufacture of tobacco products,495,353,142,0,2
All,2012 Q1,C,Manufacturing,Manufacture of textiles,5798,3200,2598,60,779
All,2012 Q1,C,Manufacturing,Manufacture of wearing apparel,10768,4888,5880,36,1021
All,2012 Q1,C,Manufacturing,"Manufacture of leather and related products; Manufacture of wood and of products of wood and cork, articles of straw and plaiting materials (except furniture and toys)",469,314,155,15,147
All,2012 Q1,C,Manufacturing,Manufacture of paper and paper products,1217,816,401,6,329
All,2012 Q1,C,Manufacturing,Printing and reproduction of recorded media,17598,11894,5704,108,2761
All,2012 Q1,C,Manufacturing,Manufacture of coke and refined petroleum products; Manufacture of chemicals and chemical products,2132,1309,823,45,218
All,2012 Q1,C,Manufacturing,"Manufacture of pharmaceuticals, medicinal chemical and botanical products",4238,1519,2719,93,248
All,2012 Q1,C,Manufacturing,"Manufacture of rubber and plastics products (except furniture, toys, sports goods and stationery)",2278,1463,815,84,420
All,2012 Q1,C,Manufacturing,Manufacture of other non-metallic mineral products,1113,940,173,46,204
All,2012 Q1,C,Manufacturing,Manufacture of basic metals,1153,1004,149,21,89
All,2012 Q1,C,Manufacturing,Manufacture of fabricated metal products (except machinery and equipment),3358,2463,895,7,843
All,2012 Q1,C,Manufacturing,"Manufacture of computer, electronic and optical products",5986,3240,2746,76,376
All,2012 Q1,C,Manufacturing,Manufacture of electrical equipment,1882,1080,802,15,234
All,2012 Q1,C,Manufacturing,Manufacture of machinery and equipment n.e.c.,2457,1875,582,29,465
All,2012 Q1,C,Manufacturing,Body assembly of motor vehicles; Manufacture of other transport equipment,1466,1294,172,109,96
All,2012 Q1,C,Manufacturing,Manufacture of furniture,427,339,88,0,134
All,2012 Q1,C,Manufacturing,Other manufacturing,7561,4434,3127,158,1429
All,2012 Q1,C,Manufacturing,Repair and installation of machinery and equipment,12138,10526,1612,1280,1274
All,2012 Q1,B,Mining and quarrying,Quarrying and other mining of non-metal ores,73,67,6,0,2
All,2012 Q1,D,Electricity and gas supply,Electricity and gas supply,7496,6365,1131,35,14
All,2012 Q1,E,"Sewerage, waste management and remediation services",Sewerage,269,239,30,2,32
All,2012 Q1,E,"Sewerage, waste management and remediation services","Waste collection, treatment and disposal; materials recovery",2548,1763,785,75,286
All,2012 Q1,E,"Sewerage, waste management and remediation services",Remediation and other waste management services,54,21,33,0,7
All,2012 Q1,F,Construction,Construction sites (manual workers only),70642,64996,5646,666,1143
All,2012 Q1,F,Construction,Public sector sites,31620,29654,1966,338,473
All,2012 Q1,F,Construction,Public sector building sites,10810,9990,820,13,164
All,2012 Q1,F,Construction,Public sector civil engineering sites,20810,19664,1146,325,309
All,2012 Q1,F,Construction,Private sector sites,39022,35342,3680,328,670
All,2012 Q1,F,Construction,Private sector building sites,37650,34063,3587,322,598
All,2012 Q1,F,Construction,Private sector civil engineering sites,1372,1279,93,6,72
All,2012 Q1,G,"Import/export, wholesale and retail trades",Import and export trade,493419,249425,243994,7628,102035
All,2012 Q1,G,"Import/export, wholesale and retail trades",Wholesale,63734,38980,24754,1317,14915
All,2012 Q1,G,"Import/export, wholesale and retail trades",Retail trade,256844,101805,155039,8180,63702
All,2012 Q1,H,"Transportation, storage, postal and courier services",Land transport,42620,36443,6177,840,2239
All,2012 Q1,H,"Transportation, storage, postal and courier services",Water transport,10532,6686,3846,135,363
All,2012 Q1,H,"Transportation, storage, postal and courier services",Air transport,23999,9189,14810,211,130
All,2012 Q1,H,"Transportation, storage, postal and courier services",Warehousing and support services for transportation,75822,47326,28496,1746,6309
All,2012 Q1,H,"Transportation, storage, postal and courier services",Postal and courier services,12664,9297,3367,265,668
All,2012 Q1,I,Accommodation and food services,Accommodation services,36449,19501,16948,968,1019
All,2012 Q1,I,Accommodation and food services,Food and beverage services,232599,109706,122893,10068,15835
All,2012 Q1,J,Information and communications,Publishing,20760,11379,9381,347,1587
All,2012 Q1,J,Information and communications,"Motion picture, video and television programme production, sound recording and music publishing; Programming and broadcasting",14537,8879,5658,361,2147
All,2012 Q1,J,Information and communications,Telecommunications,18048,11606,6442,493,321
All,2012 Q1,J,Information and communications,Information technology services,36807,27035,9772,1091,6216
All,2012 Q1,J,Information and communications,Information services,5036,2652,2384,183,702
All,2012 Q1,K,Financing and insurance,Financial services (except insurance and pension funding),132458,63655,68803,2084,7434
All,2012 Q1,K,Financing and insurance,Insurance,13387,4945,8442,497,153
All,2012 Q1,K,Financing and insurance,Services auxiliary to financial and insurance services,64106,32044,32062,1978,13103
All,2012 Q1,L,Real estate,Real estate,122055,75929,46126,3264,14208
All,2012 Q1,M,"Professional, scientific and technical services",Legal and accounting services,49174,22511,26663,767,6710
All,2012 Q1,M,"Professional, scientific and technical services",Activities of head offices; management and management consultancy services,30129,14662,15467,791,6454
All,2012 Q1,M,"Professional, scientific and technical services","Architecture and engineering services, technical testing and analysis",37493,24361,13132,910,2994
All,2012 Q1,M,"Professional, scientific and technical services",Scientific research and development,1700,1028,672,53,147
All,2012 Q1,M,"Professional, scientific and technical services",Advertising and market research,13924,7373,6551,668,3462
All,2012 Q1,M,"Professional, scientific and technical services","Veterinary services; Other professional, scientific and technical services",20536,11732,8804,621,7474
All,2012 Q1,N,Administrative and support services,Rental and leasing services,2733,1674,1059,73,626
All,2012 Q1,N,Administrative and support services,Employment services,15308,7194,8114,369,2454
All,2012 Q1,N,Administrative and support services,"Travel agency, reservation service and related services",20011,8031,11980,497,2518
All,2012 Q1,N,Administrative and support services,Security and investigation services,41060,29379,11681,1728,175
All,2012 Q1,N,Administrative and support services,Services to buildings and landscape care,78045,26779,51266,1249,1567
All,2012 Q1,N,Administrative and support services,"Office administrative, office support and other business support services",20069,9892,10177,633,4812
All,2012 Q1,P,Education,Education,170770,63955,106815,3321,10673
All,2012 Q1,Q,Human health and social work services,Human health services,99596,26578,73018,3673,6947
All,2012 Q1,Q,Human health and social work services,Residential care services,27517,3896,23621,1587,1171
All,2012 Q1,Q,Human health and social work services,Social work services,30619,7448,23171,614,1954
All,2012 Q1,R,"Arts, entertainment and recreation",Creative and performing arts activities,3072,1698,1374,21,1145
All,2012 Q1,R,"Arts, entertainment and recreation","Libraries, archives, museums and other cultural activities",542,195,347,6,86
All,2012 Q1,R,"Arts, entertainment and recreation",Amusement parks and theme parks,4805,2619,2186,145,6
All,2012 Q1,R,"Arts, entertainment and recreation",Sports and other entertainment services,34986,18734,16252,3377,1257
All,2012 Q1,S,Other services,Activities of membership organisations,9568,3736,5832,286,1117
All,2012 Q1,S,Other services,"Repair of motor vehicles, motorcycles, computers, personal and household goods",17775,14884,2891,512,6145
All,2012 Q1,S,Other services,Other personal services,45377,13195,32182,2770,11202
All,2012 Q2,C,Manufacturing,Manufacture of food products,22222,12258,9964,710,857
All,2012 Q2,C,Manufacturing,Manufacture of beverages,3828,2779,1049,116,28
All,2012 Q2,C,Manufacturing,Manufacture of tobacco products,493,347,146,0,2
All,2012 Q2,C,Manufacturing,Manufacture of textiles,5747,2880,2867,17,774
All,2012 Q2,C,Manufacturing,Manufacture of wearing apparel,10249,4120,6129,87,998
All,2012 Q2,C,Manufacturing,"Manufacture of leather and related products; Manufacture of wood and of products of wood and cork, articles of straw and plaiting materials (except furniture and toys)",473,328,145,18,151
All,2012 Q2,C,Manufacturing,Manufacture of paper and paper products,1225,869,356,18,320
All,2012 Q2,C,Manufacturing,Printing and reproduction of recorded media,17599,12257,5342,262,2777
All,2012 Q2,C,Manufacturing,Manufacture of coke and refined petroleum products; Manufacture of chemicals and chemical products,2013,1371,642,6,212
All,2012 Q2,C,Manufacturing,"Manufacture of pharmaceuticals, medicinal chemical and botanical products",4308,1700,2608,116,249
All,2012 Q2,C,Manufacturing,"Manufacture of rubber and plastics products (except furniture, toys, sports goods and stationery)",2469,1643,826,75,420
All,2012 Q2,C,Manufacturing,Manufacture of other non-metallic mineral products,1122,882,240,23,206
All,2012 Q2,C,Manufacturing,Manufacture of basic metals,1178,978,200,17,92
All,2012 Q2,C,Manufacturing,Manufacture of fabricated metal products (except machinery and equipment),3309,2189,1120,67,843
All,2012 Q2,C,Manufacturing,"Manufacture of computer, electronic and optical products",5601,3113,2488,79,365
All,2012 Q2,C,Manufacturing,Manufacture of electrical equipment,1961,1262,699,11,223
All,2012 Q2,C,Manufacturing,Manufacture of machinery and equipment n.e.c.,2334,1953,381,15,454
All,2012 Q2,C,Manufacturing,Body assembly of motor vehicles; Manufacture of other transport equipment,1546,1395,151,87,97
All,2012 Q2,C,Manufacturing,Manufacture of furniture,413,282,131,0,133
All,2012 Q2,C,Manufacturing,Other manufacturing,7568,4562,3006,149,1404
All,2012 Q2,C,Manufacturing,Repair and installation of machinery and equipment,11979,10303,1676,1062,1262
All,2012 Q2,B,Mining and quarrying,Quarrying and other mining of non-metal ores,83,76,7,0,2
All,2012 Q2,D,Electricity and gas supply,Electricity and gas supply,7537,6340,1197,27,12
All,2012 Q2,E,"Sewerage, waste management and remediation services",Sewerage,276,179,97,1,34
All,2012 Q2,E,"Sewerage, waste management and remediation services","Waste collection, treatment and disposal; materials recovery",2452,1695,757,62,281
All,2012 Q2,E,"Sewerage, waste management and remediation services",Remediation and other waste management services,63,31,32,0,6
All,2012 Q2,F,Construction,Construction sites (manual workers only),71721,64960,6761,588,1157
All,2012 Q2,F,Construction,Public sector sites,31027,29137,1890,466,464
All,2012 Q2,F,Construction,Public sector building sites,9612,8840,772,37,163
All,2012 Q2,F,Construction,Public sector civil engineering sites,21415,20297,1118,429,301
All,2012 Q2,F,Construction,Private sector sites,40694,35823,4871,122,693
All,2012 Q2,F,Construction,Private sector building sites,39260,34448,4812,105,604
All,2012 Q2,F,Construction,Private sector civil engineering sites,1434,1375,59,17,89
All,2012 Q2,G,"Import/export, wholesale and retail trades",Import and export trade,493889,252006,241883,7854,102120
All,2012 Q2,G,"Import/export, wholesale and retail trades",Wholesale,64458,38079,26379,1287,15087
All,2012 Q2,G,"Import/export, wholesale and retail trades",Retail trade,259434,103151,156283,6898,64015
All,2012 Q2,H,"Transportation, storage, postal and courier services",Land transport,43116,36950,6166,1014,2216
All,2012 Q2,H,"Transportation, storage, postal and courier services",Water transport,10729,6855,3874,195,362
All,2012 Q2,H,"Transportation, storage, postal and courier services",Air transport,24257,9396,14861,174,132
All,2012 Q2,H,"Transportation, storage, postal and courier services",Warehousing and support services for transportation,75949,48505,27444,1675,6275
All,2012 Q2,H,"Transportation, storage, postal and courier services",Postal and courier services,12655,8600,4055,350,680
All,2012 Q2,I,Accommodation and food services,Accommodation services,36612,19939,16673,1112,1029
All,2012 Q2,I,Accommodation and food services,Food and beverage services,235666,110453,125213,11154,15900
All,2012 Q2,J,Information and communications,Publishing,20964,11388,9576,244,1578
All,2012 Q2,J,Information and communications,"Motion picture, video and television programme production, sound recording and music publishing; Programming and broadcasting",14603,8929,5674,205,2152
All,2012 Q2,J,Information and communications,Telecommunications,18164,11689,6475,428,310
All,2012 Q2,J,Information and communications,Information technology services,37135,27873,9262,1345,6345
All,2012 Q2,J,Information and communications,Information services,5025,2725,2300,158,694
All,2012 Q2,K,Financing and insurance,Financial services (except insurance and pension funding),129904,62441,67463,1730,7458
All,2012 Q2,K,Financing and insurance,Insurance,13333,5079,8254,360,157
All,2012 Q2,K,Financing and insurance,Services auxiliary to financial and insurance services,63756,33764,29992,2296,13239
All,2012 Q2,L,Real estate,Real estate,124355,77730,46625,2862,14357
All,2012 Q2,M,"Professional, scientific and technical services",Legal and accounting services,49155,21773,27382,598,6748
All,2012 Q2,M,"Professional, scientific and technical services",Activities of head offices; management and management consultancy services,30221,15233,14988,940,6614
All,2012 Q2,M,"Professional, scientific and technical services","Architecture and engineering services, technical testing and analysis",37294,25079,12215,1210,3007
All,2012 Q2,M,"Professional, scientific and technical services",Scientific research and development,1547,1023,524,61,123
All,2012 Q2,M,"Professional, scientific and technical services",Advertising and market research,13954,7567,6387,270,3489
All,2012 Q2,M,"Professional, scientific and technical services","Veterinary services; Other professional, scientific and technical services",21053,11936,9117,764,7565
All,2012 Q2,N,Administrative and support services,Rental and leasing services,2796,1625,1171,82,635
All,2012 Q2,N,Administrative and support services,Employment services,15680,6948,8732,456,2481
All,2012 Q2,N,Administrative and support services,"Travel agency, reservation service and related services",20094,7538,12556,1109,2603
All,2012 Q2,N,Administrative and support services,Security and investigation services,41259,29136,12123,1701,194
All,2012 Q2,N,Administrative and support services,Services to buildings and landscape care,80185,26424,53761,1699,1588
All,2012 Q2,N,Administrative and support services,"Office administrative, office support and other business support services",20066,9606,10460,469,4860
All,2012 Q2,P,Education,Education,172325,63553,108772,3299,10907
All,2012 Q2,Q,Human health and social work services,Human health services,100367,27022,73345,4242,7084
All,2012 Q2,Q,Human health and social work services,Residential care services,27700,3839,23861,2083,1169
All,2012 Q2,Q,Human health and social work services,Social work services,31132,7497,23635,526,1977
All,2012 Q2,R,"Arts, entertainment and recreation",Creative and performing arts activities,3246,1965,1281,80,1187
All,2012 Q2,R,"Arts, entertainment and recreation","Libraries, archives, museums and other cultural activities",565,187,378,6,89
All,2012 Q2,R,"Arts, entertainment and recreation",Amusement parks and theme parks,5382,2932,2450,205,6
All,2012 Q2,R,"Arts, entertainment and recreation",Sports and other entertainment services,36624,19829,16795,2370,1267
All,2012 Q2,S,Other services,Activities of membership organisations,9490,3968,5522,333,1120
All,2012 Q2,S,Other services,"Repair of motor vehicles, motorcycles, computers, personal and household goods",17951,14550,3401,1031,6200
All,2012 Q2,S,Other services,Other personal services,45807,13647,32160,2318,11267
All,2012 Q3,C,Manufacturing,Manufacture of food products,22532,11730,10802,617,870
All,2012 Q3,C,Manufacturing,Manufacture of beverages,3612,2676,936,112,28
All,2012 Q3,C,Manufacturing,Manufacture of tobacco products,472,294,178,0,2
All,2012 Q3,C,Manufacturing,Manufacture of textiles,5478,2849,2629,11,751
All,2012 Q3,C,Manufacturing,Manufacture of wearing apparel,10071,3870,6201,20,1012
All,2012 Q3,C,Manufacturing,"Manufacture of leather and related products; Manufacture of wood and of products of wood and cork, articles of straw and plaiting materials (except furniture and toys)",533,375,158,9,149
All,2012 Q3,C,Manufacturing,Manufacture of paper and paper products,1166,844,322,5,314
All,2012 Q3,C,Manufacturing,Printing and reproduction of recorded media,17561,11093,6468,113,2780
All,2012 Q3,C,Manufacturing,Manufacture of coke and refined petroleum products; Manufacture of chemicals and chemical products,2014,1392,622,14,218
All,2012 Q3,C,Manufacturing,"Manufacture of pharmaceuticals, medicinal chemical and botanical products",4301,1743,2558,97,247
All,2012 Q3,C,Manufacturing,"Manufacture of rubber and plastics products (except furniture, toys, sports goods and stationery)",2326,1552,774,53,408
All,2012 Q3,C,Manufacturing,Manufacture of other non-metallic mineral products,1138,927,211,39,205
All,2012 Q3,C,Manufacturing,Manufacture of basic metals,1211,997,214,23,92
All,2012 Q3,C,Manufacturing,Manufacture of fabricated metal products (except machinery and equipment),3452,2311,1141,48,844
All,2012 Q3,C,Manufacturing,"Manufacture of computer, electronic and optical products",5325,2776,2549,55,363
All,2012 Q3,C,Manufacturing,Manufacture of electrical equipment,1919,1112,807,25,217
All,2012 Q3,C,Manufacturing,Manufacture of machinery and equipment n.e.c.,2327,1910,417,35,445
All,2012 Q3,C,Manufacturing,Body assembly of motor vehicles; Manufacture of other transport equipment,1466,1304,162,105,96
All,2012 Q3,C,Manufacturing,Manufacture of furniture,454,336,118,0,135
All,2012 Q3,C,Manufacturing,Other manufacturing,7492,4632,2860,88,1376
All,2012 Q3,C,Manufacturing,Repair and installation of machinery and equipment,11930,9956,1974,847,1268
All,2012 Q3,B,Mining and quarrying,Quarrying and other mining of non-metal ores,72,65,7,0,2
All,2012 Q3,D,Electricity and gas supply,Electricity and gas supply,7615,6413,1202,33,9
All,2012 Q3,E,"Sewerage, waste management and remediation services",Sewerage,269,239,30,15,35
All,2012 Q3,E,"Sewerage, waste management and remediation services","Waste collection, treatment and disposal; materials recovery",2349,1558,791,59,289
All,2012 Q3,E,"Sewerage, waste management and remediation services",Remediation and other waste management services,55,22,33,0,5
All,2012 Q3,F,Construction,Construction sites (manual workers only),72238,65808,6430,511,1209
All,2012 Q3,F,Construction,Public sector sites,33390,31384,2006,444,486
All,2012 Q3,F,Construction,Public sector building sites,11311,10526,785,14,171
All,2012 Q3,F,Construction,Public sector civil engineering sites,22079,20858,1221,430,315
All,2012 Q3,F,Construction,Private sector sites,38848,34424,4424,67,723
All,2012 Q3,F,Construction,Private sector building sites,37375,33014,4361,62,624
All,2012 Q3,F,Construction,Private sector civil engineering sites,1473,1410,63,5,99
All,2012 Q3,G,"Import/export, wholesale and retail trades",Import and export trade,491739,254837,236902,6565,101409
All,2012 Q3,G,"Import/export, wholesale and retail trades",Wholesale,63636,38844,24792,1671,14951
All,2012 Q3,G,"Import/export, wholesale and retail trades",Retail trade,259694,103943,155751,8954,63972
All,2012 Q3,H,"Transportation, storage, postal and courier services",Land transport,43650,37858,5792,942,2188
All,2012 Q3,H,"Transportation, storage, postal and courier services",Water transport,10443,6560,3883,185,356
All,2012 Q3,H,"Transportation, storage, postal and courier services",Air transport,24757,9745,15012,240,134
All,2012 Q3,H,"Transportation, storage, postal and courier services",Warehousing and support services for transportation,75548,47886,27662,1830,6268
All,2012 Q3,H,"Transportation, storage, postal and courier services",Postal and courier services,12493,8719,3774,345,670
All,2012 Q3,I,Accommodation and food services,Accommodation services,37520,19669,17851,1094,1048
All,2012 Q3,I,Accommodation and food services,Food and beverage services,236226,108415,127811,11848,15731
All,2012 Q3,J,Information and communications,Publishing,21227,11716,9511,317,1575
All,2012 Q3,J,Information and communications,"Motion picture, video and television programme production, sound recording and music publishing; Programming and broadcasting",14963,9557,5406,313,2194
All,2012 Q3,J,Information and communications,Telecommunications,18519,11919,6600,426,299
All,2012 Q3,J,Information and communications,Information technology services,37648,28603,9045,950,6442
All,2012 Q3,J,Information and communications,Information services,5121,2767,2354,145,699
All,2012 Q3,K,Financing and insurance,Financial services (except insurance and pension funding),129302,62138,67164,1689,7410
All,2012 Q3,K,Financing and insurance,Insurance,13531,5082,8449,370,153
All,2012 Q3,K,Financing and insurance,Services auxiliary to financial and insurance services,63841,33059,30782,1451,13433
All,2012 Q3,L,Real estate,Real estate,125645,77571,48074,3807,14539
All,2012 Q3,M,"Professional, scientific and technical services",Legal and accounting services,49558,22328,27230,563,6837
All,2012 Q3,M,"Professional, scientific and technical services",Activities of head offices; management and management consultancy services,30061,15067,14994,816,6695
All,2012 Q3,M,"Professional, scientific and technical services","Architecture and engineering services, technical testing and analysis",37512,24563,12949,1331,3032
All,2012 Q3,M,"Professional, scientific and technical services",Scientific research and development,1540,991,549,104,130
All,2012 Q3,M,"Professional, scientific and technical services",Advertising and market research,14288,8256,6032,320,3497
All,2012 Q3,M,"Professional, scientific and technical services","Veterinary services; Other professional, scientific and technical services",21348,12153,9195,461,7630
All,2012 Q3,N,Administrative and support services,Rental and leasing services,2762,1538,1224,73,632
All,2012 Q3,N,Administrative and support services,Employment services,15865,7399,8466,578,2461
All,2012 Q3,N,Administrative and support services,"Travel agency, reservation service and related services",19917,7605,12312,488,2617
All,2012 Q3,N,Administrative and support services,Security and investigation services,42259,29640,12619,1749,204
All,2012 Q3,N,Administrative and support services,Services to buildings and landscape care,80677,26613,54064,1622,1601
All,2012 Q3,N,Administrative and support services,"Office administrative, office support and other business support services",20075,9792,10283,402,4918
All,2012 Q3,P,Education,Education,171901,64137,107764,3280,10992
All,2012 Q3,Q,Human health and social work services,Human health services,102100,27566,74534,2802,7136
All,2012 Q3,Q,Human health and social work services,Residential care services,27502,4168,23334,1676,1158
All,2012 Q3,Q,Human health and social work services,Social work services,30948,7150,23798,506,1981
All,2012 Q3,R,"Arts, entertainment and recreation",Creative and performing arts activities,3258,1852,1406,50,1208
All,2012 Q3,R,"Arts, entertainment and recreation","Libraries, archives, museums and other cultural activities",589,185,404,12,88
All,2012 Q3,R,"Arts, entertainment and recreation",Amusement parks and theme parks,5878,3279,2599,178,6
All,2012 Q3,R,"Arts, entertainment and recreation",Sports and other entertainment services,35191,17961,17230,2953,1305
All,2012 Q3,S,Other services,Activities of membership organisations,9698,3959,5739,286,1125
All,2012 Q3,S,Other services,"Repair of motor vehicles, motorcycles, computers, personal and household goods",18099,15298,2801,575,6235
All,2012 Q3,S,Other services,Other personal services,45588,13768,31820,2504,11148
All,2012 Q4,C,Manufacturing,Manufacture of food products,22044,11073,10971,712,857
All,2012 Q4,C,Manufacturing,Manufacture of beverages,3640,2702,938,82,29
All,2012 Q4,C,Manufacturing,Manufacture of tobacco products,501,352,149,0,2
All,2012 Q4,C,Manufacturing,Manufacture of textiles,5380,2779,2601,34,738
All,2012 Q4,C,Manufacturing,Manufacture of wearing apparel,9871,3769,6102,37,988
All,2012 Q4,C,Manufacturing,"Manufacture of leather and related products; Manufacture of wood and of products of wood and cork, articles of straw and plaiting materials (except furniture and toys)",492,330,162,9,147
All,2012 Q4,C,Manufacturing,Manufacture of paper and paper products,1147,755,392,11,309
All,2012 Q4,C,Manufacturing,Printing and reproduction of recorded media,17405,11960,5445,125,2738
All,2012 Q4,C,Manufacturing,Manufacture of coke and refined petroleum products; Manufacture of chemicals and chemical products,1960,1137,823,19,217
All,2012 Q4,C,Manufacturing,"Manufacture of pharmaceuticals, medicinal chemical and botanical products",4374,2122,2252,50,249
All,2012 Q4,C,Manufacturing,"Manufacture of rubber and plastics products (except furniture, toys, sports goods and stationery)",2373,1688,685,56,400
All,2012 Q4,C,Manufacturing,Manufacture of other non-metallic mineral products,1189,1003,186,39,207
All,2012 Q4,C,Manufacturing,Manufacture of basic metals,1161,959,202,26,90
All,2012 Q4,C,Manufacturing,Manufacture of fabricated metal products (except machinery and equipment),3310,2105,1205,61,835
All,2012 Q4,C,Manufacturing,"Manufacture of computer, electronic and optical products",5031,2648,2383,53,356
All,2012 Q4,C,Manufacturing,Manufacture of electrical equipment,1763,1150,613,18,214
All,2012 Q4,C,Manufacturing,Manufacture of machinery and equipment n.e.c.,2169,1791,378,81,429
All,2012 Q4,C,Manufacturing,Body assembly of motor vehicles; Manufacture of other transport equipment,1661,1457,204,80,88
All,2012 Q4,C,Manufacturing,Manufacture of furniture,471,321,150,0,136
All,2012 Q4,C,Manufacturing,Other manufacturing,7504,4789,2715,177,1391
All,2012 Q4,C,Manufacturing,Repair and installation of machinery and equipment,11862,10091,1771,1051,1296
All,2012 Q4,B,Mining and quarrying,Quarrying and other mining of non-metal ores,73,65,8,0,2
All,2012 Q4,D,Electricity and gas supply,Electricity and gas supply,7673,6430,1243,40,8
All,2012 Q4,E,"Sewerage, waste management and remediation services",Sewerage,233,190,43,2,34
All,2012 Q4,E,"Sewerage, waste management and remediation services","Waste collection, treatment and disposal; materials recovery",2316,1597,719,44,324
All,2012 Q4,E,"Sewerage, waste management and remediation services",Remediation and other waste management services,53,21,32,0,5
All,2012 Q4,F,Construction,Construction sites (manual workers only),70578,64441,6137,801,1158
All,2012 Q4,F,Construction,Public sector sites,32758,30600,2158,619,441
All,2012 Q4,F,Construction,Public sector building sites,10579,9857,722,55,144
All,2012 Q4,F,Construction,Public sector civil engineering sites,22179,20743,1436,564,297
All,2012 Q4,F,Construction,Private sector sites,37820,33841,3979,182,717
All,2012 Q4,F,Construction,Private sector building sites,36461,32553,3908,172,626
All,2012 Q4,F,Construction,Private sector civil engineering sites,1359,1288,71,10,91
All,2012 Q4,G,"Import/export, wholesale and retail trades",Import and export trade,491260,253347,237913,6462,101342
All,2012 Q4,G,"Import/export, wholesale and retail trades",Wholesale,63368,38483,24885,1243,14768
All,2012 Q4,G,"Import/export, wholesale and retail trades",Retail trade,260246,103067,157179,7556,63909
All,2012 Q4,H,"Transportation, storage, postal and courier services",Land transport,43946,37870,6076,841,2136
All,2012 Q4,H,"Transportation, storage, postal and courier services",Water transport,10326,6638,3688,173,362
All,2012 Q4,H,"Transportation, storage, postal and courier services",Air transport,24806,9816,14990,211,136
All,2012 Q4,H,"Transportation, storage, postal and courier services",Warehousing and support services for transportation,75709,47042,28667,1580,6267
All,2012 Q4,H,"Transportation, storage, postal and courier services",Postal and courier services,12454,9049,3405,209,668
All,2012 Q4,I,Accommodation and food services,Accommodation services,38193,20336,17857,937,1068
All,2012 Q4,I,Accommodation and food services,Food and beverage services,236002,107944,128058,10922,15903
All,2012 Q4,J,Information and communications,Publishing,21056,10895,10161,241,1601
All,2012 Q4,J,Information and communications,"Motion picture, video and television programme production, sound recording and music publishing; Programming and broadcasting",15117,9651,5466,364,2258
All,2012 Q4,J,Information and communications,Telecommunications,18799,12010,6789,533,312
All,2012 Q4,J,Information and communications,Information technology services,37139,27845,9294,1131,6512
All,2012 Q4,J,Information and communications,Information services,5119,3021,2098,211,685
All,2012 Q4,K,Financing and insurance,Financial services (except insurance and pension funding),130318,62940,67378,2075,7427
All,2012 Q4,K,Financing and insurance,Insurance,13494,5106,8388,394,153
All,2012 Q4,K,Financing and insurance,Services auxiliary to financial and insurance services,63888,33295,30593,1643,13691
All,2012 Q4,L,Real estate,Real estate,125938,80307,45631,2932,14673
All,2012 Q4,M,"Professional, scientific and technical services",Legal and accounting services,49362,21955,27407,503,6886
All,2012 Q4,M,"Professional, scientific and technical services",Activities of head offices; management and management consultancy services,32282,15401,16881,1244,6806
All,2012 Q4,M,"Professional, scientific and technical services","Architecture and engineering services, technical testing and analysis",37857,25242,12615,1036,3064
All,2012 Q4,M,"Professional, scientific and technical services",Scientific research and development,1664,970,694,76,130
All,2012 Q4,M,"Professional, scientific and technical services",Advertising and market research,14196,7756,6440,283,3514
All,2012 Q4,M,"Professional, scientific and technical services","Veterinary services; Other professional, scientific and technical services",20730,11877,8853,400,7728
All,2012 Q4,N,Administrative and support services,Rental and leasing services,2693,1664,1029,57,609
All,2012 Q4,N,Administrative and support services,Employment services,15963,7387,8576,608,2482
All,2012 Q4,N,Administrative and support services,"Travel agency, reservation service and related services",19952,7713,12239,620,2604
All,2012 Q4,N,Administrative and support services,Security and investigation services,42234,29753,12481,1747,192
All,2012 Q4,N,Administrative and support services,Services to buildings and landscape care,80271,28681,51590,1698,1609
All,2012 Q4,N,Administrative and support services,"Office administrative, office support and other business support services",20204,9298,10906,437,4933
All,2012 Q4,P,Education,Education,173550,64973,108577,2719,11348
All,2012 Q4,Q,Human health and social work services,Human health services,103404,27980,75424,1334,7128
All,2012 Q4,Q,Human health and social work services,Residential care services,27590,3697,23893,1808,1156
All,2012 Q4,Q,Human health and social work services,Social work services,31171,7644,23527,514,1998
All,2012 Q4,R,"Arts, entertainment and recreation",Creative and performing arts activities,3367,1773,1594,79,1238
All,2012 Q4,R,"Arts, entertainment and recreation","Libraries, archives, museums and other cultural activities",609,248,361,25,84
All,2012 Q4,R,"Arts, entertainment and recreation",Amusement parks and theme parks,5666,3099,2567,32,6
All,2012 Q4,R,"Arts, entertainment and recreation",Sports and other entertainment services,35404,18877,16527,3491,1283
All,2012 Q4,S,Other services,Activities of membership organisations,9599,4649,4950,468,1129
All,2012 Q4,S,Other services,"Repair of motor vehicles, motorcycles, computers, personal and household goods",18408,15323,3085,447,6242
All,2012 Q4,S,Other services,Other personal services,45442,13521,31921,2148,11120
All,2013 Q1,C,Manufacturing,Manufacture of food products,22180,11757,10423,684,856
All,2013 Q1,C,Manufacturing,Manufacture of beverages,3439,2520,919,71,30
All,2013 Q1,C,Manufacturing,Manufacture of tobacco products,494,340,154,0,2
All,2013 Q1,C,Manufacturing,Manufacture of textiles,5228,2745,2483,4,730
All,2013 Q1,C,Manufacturing,Manufacture of wearing apparel,9569,3618,5951,97,991
All,2013 Q1,C,Manufacturing,"Manufacture of leather and related products; Manufacture of wood and of products of wood and cork, articles of straw and plaiting materials (except furniture and toys)",466,321,145,0,147
All,2013 Q1,C,Manufacturing,Manufacture of paper and paper products,1127,819,308,5,308
All,2013 Q1,C,Manufacturing,Printing and reproduction of recorded media,17368,11670,5698,141,2737
All,2013 Q1,C,Manufacturing,Manufacture of coke and refined petroleum products; Manufacture of chemicals and chemical products,1854,1149,705,38,215
All,2013 Q1,C,Manufacturing,"Manufacture of pharmaceuticals, medicinal chemical and botanical products",4355,1870,2485,81,246
All,2013 Q1,C,Manufacturing,"Manufacture of rubber and plastics products (except furniture, toys, sports goods and stationery)",2467,1472,995,48,412
All,2013 Q1,C,Manufacturing,Manufacture of other non-metallic mineral products,1224,981,243,32,203
All,2013 Q1,C,Manufacturing,Manufacture of basic metals,1114,905,209,42,90
All,2013 Q1,C,Manufacturing,Manufacture of fabricated metal products (except machinery and equipment),3351,2289,1062,74,841
All,2013 Q1,C,Manufacturing,"Manufacture of computer, electronic and optical products",4513,2488,2025,77,344
All,2013 Q1,C,Manufacturing,Manufacture of electrical equipment,1785,1261,524,22,213
All,2013 Q1,C,Manufacturing,Manufacture of machinery and equipment n.e.c.,2222,1916,306,65,409
All,2013 Q1,C,Manufacturing,Body assembly of motor vehicles; Manufacture of other transport equipment,1526,1352,174,18,91
All,2013 Q1,C,Manufacturing,Manufacture of furniture,473,346,127,12,143
All,2013 Q1,C,Manufacturing,Other manufacturing,7322,4385,2937,209,1367
All,2013 Q1,C,Manufacturing,Repair and installation of machinery and equipment,11945,10102,1843,839,1285
All,2013 Q1,B,Mining and quarrying,Quarrying and other mining of non-metal ores,74,66,8,0,2
All,2013 Q1,D,Electricity and gas supply,Electricity and gas supply,7630,6378,1252,37,8
All,2013 Q1,E,"Sewerage, waste management and remediation services",Sewerage,230,162,68,12,34
All,2013 Q1,E,"Sewerage, waste management and remediation services","Waste collection, treatment and disposal; materials recovery",2425,1491,934,59,345
All,2013 Q1,E,"Sewerage, waste management and remediation services",Remediation and other waste management services,41,8,33,0,5
All,2013 Q1,F,Construction,Construction sites (manual workers only),77803,70483,7320,930,1228
All,2013 Q1,F,Construction,Public sector sites,36903,34459,2444,649,473
All,2013 Q1,F,Construction,Public sector building sites,11744,10877,867,14,146
All,2013 Q1,F,Construction,Public sector civil engineering sites,25159,23582,1577,635,327
All,2013 Q1,F,Construction,Private sector sites,40900,36024,4876,281,755
All,2013 Q1,F,Construction,Private sector building sites,39845,35036,4809,271,676
All,2013 Q1,F,Construction,Private sector civil engineering sites,1055,988,67,10,79
All,2013 Q1,G,"Import/export, wholesale and retail trades",Import and export trade,495218,256899,238319,8545,102155
All,2013 Q1,G,"Import/export, wholesale and retail trades",Wholesale,62767,38659,24108,1898,14619
All,2013 Q1,G,"Import/export, wholesale and retail trades",Retail trade,262670,103888,158782,9404,64960
All,2013 Q1,H,"Transportation, storage, postal and courier services",Land transport,44059,38388,5671,1185,2119
All,2013 Q1,H,"Transportation, storage, postal and courier services",Water transport,10782,6835,3947,144,388
All,2013 Q1,H,"Transportation, storage, postal and courier services",Air transport,24748,9617,15131,205,145
All,2013 Q1,H,"Transportation, storage, postal and courier services",Warehousing and support services for transportation,76194,47726,28468,1730,6344
All,2013 Q1,H,"Transportation, storage, postal and courier services",Postal and courier services,12325,8943,3382,351,665
All,2013 Q1,I,Accommodation and food services,Accommodation services,38114,20460,17654,1477,1096
All,2013 Q1,I,Accommodation and food services,Food and beverage services,237476,110342,127134,14069,16108
All,2013 Q1,J,Information and communications,Publishing,21065,11703,9362,307,1587
All,2013 Q1,J,Information and communications,"Motion picture, video and television programme production, sound recording and music publishing; Programming and broadcasting",15452,9555,5897,533,2277
All,2013 Q1,J,Information and communications,Telecommunications,18372,11787,6585,501,312
All,2013 Q1,J,Information and communications,Information technology services,38030,29075,8955,1162,6724
All,2013 Q1,J,Information and communications,Information services,5457,3013,2444,176,704
All,2013 Q1,K,Financing and insurance,Financial services (except insurance and pension funding),129105,63078,66027,2121,7416
All,2013 Q1,K,Financing and insurance,Insurance,13574,5029,8545,365,154
All,2013 Q1,K,Financing and insurance,Services auxiliary to financial and insurance services,64915,33311,31604,2569,13860
All,2013 Q1,L,Real estate,Real estate,126997,78355,48642,3756,14929
All,2013 Q1,M,"Professional, scientific and technical services",Legal and accounting services,50076,22715,27361,806,6996
All,2013 Q1,M,"Professional, scientific and technical services",Activities of head offices; management and management consultancy services,31909,15895,16014,931,6866
All,2013 Q1,M,"Professional, scientific and technical services","Architecture and engineering services, technical testing and analysis",38543,25522,13021,1209,3083
All,2013 Q1,M,"Professional, scientific and technical services",Scientific research and development,1886,1292,594,88,132
All,2013 Q1,M,"Professional, scientific and technical services",Advertising and market research,14268,7823,6445,347,3589
All,2013 Q1,M,"Professional, scientific and technical services","Veterinary services; Other professional, scientific and technical services",21252,12239,9013,515,8020
All,2013 Q1,N,Administrative and support services,Rental and leasing services,2807,1711,1096,36,631
All,2013 Q1,N,Administrative and support services,Employment services,16028,7160,8868,482,2551
All,2013 Q1,N,Administrative and support services,"Travel agency, reservation service and related services",20109,6954,13155,706,2640
All,2013 Q1,N,Administrative and support services,Security and investigation services,43472,30273,13199,1636,209
All,2013 Q1,N,Administrative and support services,Services to buildings and landscape care,80724,26912,53812,1428,1656
All,2013 Q1,N,Administrative and support services,"Office administrative, office support and other business support services",20466,9494,10972,513,4983
All,2013 Q1,P,Education,Education,176054,64987,111067,3470,11702
All,2013 Q1,Q,Human health and social work services,Human health services,104638,28183,76455,4027,7220
All,2013 Q1,Q,Human health and social work services,Residential care services,27844,3995,23849,2199,1177
All,2013 Q1,Q,Human health and social work services,Social work services,31447,7586,23861,606,2035
All,2013 Q1,R,"Arts, entertainment and recreation",Creative and performing arts activities,3408,1969,1439,108,1331
All,2013 Q1,R,"Arts, entertainment and recreation","Libraries, archives, museums and other cultural activities",617,241,376,14,85
All,2013 Q1,R,"Arts, entertainment and recreation",Amusement parks and theme parks,5468,2993,2475,219,6
All,2013 Q1,R,"Arts, entertainment and recreation",Sports and other entertainment services,34896,18440,16456,3047,1292
All,2013 Q1,S,Other services,Activities of membership organisations,9726,4083,5643,336,1136
All,2013 Q1,S,Other services,"Repair of motor vehicles, motorcycles, computers, personal and household goods",18597,15375,3222,844,6334
All,2013 Q1,S,Other services,Other personal services,45943,13443,32500,2460,11326
All,2013 Q2,C,Manufacturing,Manufacture of food products,22628,12531,10097,975,876
All,2013 Q2,C,Manufacturing,Manufacture of beverages,3433,2596,837,93,30
All,2013 Q2,C,Manufacturing,Manufacture of tobacco products,486,331,155,0,2
All,2013 Q2,C,Manufacturing,Manufacture of textiles,5071,2526,2545,65,720
All,2013 Q2,C,Manufacturing,Manufacture of wearing apparel,9152,3489,5663,64,994
All,2013 Q2,C,Manufacturing,"Manufacture of leather and related products; Manufacture of wood and of products of wood and cork, articles of straw and plaiting materials (except furniture and toys)",480,325,155,13,141
All,2013 Q2,C,Manufacturing,Manufacture of paper and paper products,1092,730,362,11,310
All,2013 Q2,C,Manufacturing,Printing and reproduction of recorded media,16995,11443,5552,165,2704
All,2013 Q2,C,Manufacturing,Manufacture of coke and refined petroleum products; Manufacture of chemicals and chemical products,1801,1266,535,11,211
All,2013 Q2,C,Manufacturing,"Manufacture of pharmaceuticals, medicinal chemical and botanical products",4523,1675,2848,98,245
All,2013 Q2,C,Manufacturing,"Manufacture of rubber and plastics products (except furniture, toys, sports goods and stationery)",2475,1569,906,93,409
All,2013 Q2,C,Manufacturing,Manufacture of other non-metallic mineral products,1117,871,246,52,198
All,2013 Q2,C,Manufacturing,Manufacture of basic metals,1133,947,186,33,91
All,2013 Q2,C,Manufacturing,Manufacture of fabricated metal products (except machinery and equipment),3283,2319,964,15,827
All,2013 Q2,C,Manufacturing,"Manufacture of computer, electronic and optical products",4324,2373,1951,55,339
All,2013 Q2,C,Manufacturing,Manufacture of electrical equipment,1770,1147,623,16,217
All,2013 Q2,C,Manufacturing,Manufacture of machinery and equipment n.e.c.,2221,1793,428,100,404
All,2013 Q2,C,Manufacturing,Body assembly of motor vehicles; Manufacture of other transport equipment,1512,1337,175,20,90
All,2013 Q2,C,Manufacturing,Manufacture of furniture,456,330,126,0,145
All,2013 Q2,C,Manufacturing,Other manufacturing,7409,4696,2713,145,1364
All,2013 Q2,C,Manufacturing,Repair and installation of machinery and equipment,11989,10297,1692,589,1292
All,2013 Q2,B,Mining and quarrying,Quarrying and other mining of non-metal ores,76,68,8,0,2
All,2013 Q2,D,Electricity and gas supply,Electricity and gas supply,7639,6418,1221,55,8
All,2013 Q2,E,"Sewerage, waste management and remediation services",Sewerage,238,48,190,0,33
All,2013 Q2,E,"Sewerage, waste management and remediation services","Waste collection, treatment and disposal; materials recovery",2679,1754,925,88,366
All,2013 Q2,E,"Sewerage, waste management and remediation services",Remediation and other waste management services,36,29,7,0,5
All,2013 Q2,F,Construction,Construction sites (manual workers only),82542,75220,7322,1025,1247
All,2013 Q2,F,Construction,Public sector sites,38176,35458,2718,652,457
All,2013 Q2,F,Construction,Public sector building sites,10701,9650,1051,32,125
All,2013 Q2,F,Construction,Public sector civil engineering sites,27475,25808,1667,620,332
All,2013 Q2,F,Construction,Private sector sites,44366,39762,4604,373,790
All,2013 Q2,F,Construction,Private sector building sites,43217,38689,4528,343,696
All,2013 Q2,F,Construction,Private sector civil engineering sites,1149,1073,76,30,94
All,2013 Q2,G,"Import/export, wholesale and retail trades",Import and export trade,491729,250052,241677,8676,101731
All,2013 Q2,G,"Import/export, wholesale and retail trades",Wholesale,62643,37766,24877,1441,14604
All,2013 Q2,G,"Import/export, wholesale and retail trades",Retail trade,264805,104847,159958,8124,65046
All,2013 Q2,H,"Transportation, storage, postal and courier services",Land transport,44306,37856,6450,872,2106
All,2013 Q2,H,"Transportation, storage, postal and courier services",Water transport,11132,6738,4394,86,395
All,2013 Q2,H,"Transportation, storage, postal and courier services",Air transport,24617,9542,15075,211,147
All,2013 Q2,H,"Transportation, storage, postal and courier services",Warehousing and support services for transportation,76911,47688,29223,2460,6340
All,2013 Q2,H,"Transportation, storage, postal and courier services",Postal and courier services,12380,8541,3839,472,664
All,2013 Q2,I,Accommodation and food services,Accommodation services,38273,20415,17858,1606,1119
All,2013 Q2,I,Accommodation and food services,Food and beverage services,237934,108464,129470,11364,16082
All,2013 Q2,J,Information and communications,Publishing,21479,12026,9453,392,1584
All,2013 Q2,J,Information and communications,"Motion picture, video and television programme production, sound recording and music publishing; Programming and broadcasting",15894,9687,6207,517,2303
All,2013 Q2,J,Information and communications,Telecommunications,19351,12767,6584,548,327
All,2013 Q2,J,Information and communications,Information technology services,38882,29186,9696,1336,6870
All,2013 Q2,J,Information and communications,Information services,5467,3127,2340,261,723
All,2013 Q2,K,Financing and insurance,Financial services (except insurance and pension funding),128558,62664,65894,2236,7384
All,2013 Q2,K,Financing and insurance,Insurance,13341,5121,8220,441,153
All,2013 Q2,K,Financing and insurance,Services auxiliary to financial and insurance services,65447,33081,32366,2583,14146
All,2013 Q2,L,Real estate,Real estate,126415,79184,47231,3523,15071
All,2013 Q2,M,"Professional, scientific and technical services",Legal and accounting services,49713,22031,27682,615,7049
All,2013 Q2,M,"Professional, scientific and technical services",Activities of head offices; management and management consultancy services,32467,15983,16484,671,7033
All,2013 Q2,M,"Professional, scientific and technical services","Architecture and engineering services, technical testing and analysis",38763,26447,12316,1194,3176
All,2013 Q2,M,"Professional, scientific and technical services",Scientific research and development,2108,1491,617,149,152
All,2013 Q2,M,"Professional, scientific and technical services",Advertising and market research,14230,7564,6666,378,3631
All,2013 Q2,M,"Professional, scientific and technical services","Veterinary services; Other professional, scientific and technical services",21583,12166,9417,730,8128
All,2013 Q2,N,Administrative and support services,Rental and leasing services,2869,1583,1286,72,629
All,2013 Q2,N,Administrative and support services,Employment services,16161,7014,9147,528,2578
All,2013 Q2,N,Administrative and support services,"Travel agency, reservation service and related services",20142,7892,12250,936,2687
All,2013 Q2,N,Administrative and support services,Security and investigation services,44588,30587,14001,1942,209
All,2013 Q2,N,Administrative and support services,Services to buildings and landscape care,81440,26117,55323,1466,1658
All,2013 Q2,N,Administrative and support services,"Office administrative, office support and other business support services",20480,9742,10738,488,5087
All,2013 Q2,P,Education,Education,176973,64423,112550,3693,12042
All,2013 Q2,Q,Human health and social work services,Human health services,105796,28682,77114,4324,7357
All,2013 Q2,Q,Human health and social work services,Residential care services,27952,3666,24286,2543,1169
All,2013 Q2,Q,Human health and social work services,Social work services,31126,8127,22999,919,2068
All,2013 Q2,R,"Arts, entertainment and recreation",Creative and performing arts activities,3527,2081,1446,52,1369
All,2013 Q2,R,"Arts, entertainment and recreation","Libraries, archives, museums and other cultural activities",576,201,375,22,84
All,2013 Q2,R,"Arts, entertainment and recreation",Amusement parks and theme parks,5917,3219,2698,209,6
All,2013 Q2,R,"Arts, entertainment and recreation",Sports and other entertainment services,34899,18458,16441,1955,1289
All,2013 Q2,S,Other services,Activities of membership organisations,9712,4095,5617,250,1160
All,2013 Q2,S,Other services,"Repair of motor vehicles, motorcycles, computers, personal and household goods",18384,14912,3472,778,6349
All,2013 Q2,S,Other services,Other personal services,46111,13978,32133,2945,11301
All,2013 Q3,C,Manufacturing,Manufacture of food products,22708,12314,10394,973,914
All,2013 Q3,C,Manufacturing,Manufacture of beverages,3212,2308,904,54,30
All,2013 Q3,C,Manufacturing,Manufacture of tobacco products,502,340,162,26,3
All,2013 Q3,C,Manufacturing,Manufacture of textiles,4882,2628,2254,13,699
All,2013 Q3,C,Manufacturing,Manufacture of wearing apparel,9134,3715,5419,52,989
All,2013 Q3,C,Manufacturing,"Manufacture of leather and related products; Manufacture of wood and of products of wood and cork, articles of straw and plaiting materials (except furniture and toys)",452,325,127,21,142
All,2013 Q3,C,Manufacturing,Manufacture of paper and paper products,1070,766,304,3,308
All,2013 Q3,C,Manufacturing,Printing and reproduction of recorded media,17089,11591,5498,263,2692
All,2013 Q3,C,Manufacturing,Manufacture of coke and refined petroleum products; Manufacture of chemicals and chemical products,1800,1016,784,102,212
All,2013 Q3,C,Manufacturing,"Manufacture of pharmaceuticals, medicinal chemical and botanical products",4661,1895,2766,64,246
All,2013 Q3,C,Manufacturing,"Manufacture of rubber and plastics products (except furniture, toys, sports goods and stationery)",2375,1519,856,29,399
All,2013 Q3,C,Manufacturing,Manufacture of other non-metallic mineral products,1130,971,159,38,198
All,2013 Q3,C,Manufacturing,Manufacture of basic metals,1174,900,274,48,90
All,2013 Q3,C,Manufacturing,Manufacture of fabricated metal products (except machinery and equipment),3278,2319,959,65,801
All,2013 Q3,C,Manufacturing,"Manufacture of computer, electronic and optical products",4078,2091,1987,79,334
All,2013 Q3,C,Manufacturing,Manufacture of electrical equipment,1853,922,931,24,217
All,2013 Q3,C,Manufacturing,Manufacture of machinery and equipment n.e.c.,2246,1860,386,101,396
All,2013 Q3,C,Manufacturing,Body assembly of motor vehicles; Manufacture of other transport equipment,1267,967,300,8,86
All,2013 Q3,C,Manufacturing,Manufacture of furniture,458,361,97,15,145
All,2013 Q3,C,Manufacturing,Other manufacturing,7573,4318,3255,135,1396
All,2013 Q3,C,Manufacturing,Repair and installation of machinery and equipment,12972,10786,2186,587,1289
All,2013 Q3,B,Mining and quarrying,Quarrying and other mining of non-metal ores,77,68,9,0,2
All,2013 Q3,D,Electricity and gas supply,Electricity and gas supply,7657,6466,1191,70,8
All,2013 Q3,E,"Sewerage, waste management and remediation services",Sewerage,231,192,39,0,32
All,2013 Q3,E,"Sewerage, waste management and remediation services","Waste collection, treatment and disposal; materials recovery",2915,1932,983,230,374
All,2013 Q3,E,"Sewerage, waste management and remediation services",Remediation and other waste management services,32,25,7,0,5
All,2013 Q3,F,Construction,Construction sites (manual workers only),76804,69744,7060,885,1315
All,2013 Q3,F,Construction,Public sector sites,35850,33237,2613,624,490
All,2013 Q3,F,Construction,Public sector building sites,8508,7623,885,44,132
All,2013 Q3,F,Construction,Public sector civil engineering sites,27342,25614,1728,580,358
All,2013 Q3,F,Construction,Private sector sites,40954,36507,4447,261,825
All,2013 Q3,F,Construction,Private sector building sites,39450,35084,4366,248,720
All,2013 Q3,F,Construction,Private sector civil engineering sites,1504,1423,81,13,105
All,2013 Q3,G,"Import/export, wholesale and retail trades",Import and export trade,489576,247005,242571,8634,101521
All,2013 Q3,G,"Import/export, wholesale and retail trades",Wholesale,62052,37220,24832,1501,14455
All,2013 Q3,G,"Import/export, wholesale and retail trades",Retail trade,264751,104587,160164,9186,64929
All,2013 Q3,H,"Transportation, storage, postal and courier services",Land transport,44489,38083,6406,929,2077
All,2013 Q3,H,"Transportation, storage, postal and courier services",Water transport,11294,6802,4492,122,402
All,2013 Q3,H,"Transportation, storage, postal and courier services",Air transport,25172,9749,15423,149,149
All,2013 Q3,H,"Transportation, storage, postal and courier services",Warehousing and support services for transportation,77933,47530,30403,1897,6393
All,2013 Q3,H,"Transportation, storage, postal and courier services",Postal and courier services,12100,7937,4163,545,652
All,2013 Q3,I,Accommodation and food services,Accommodation services,39181,20814,18367,1492,1134
All,2013 Q3,I,Accommodation and food services,Food and beverage services,236714,108832,127882,12870,15939
All,2013 Q3,J,Information and communications,Publishing,21424,11530,9894,347,1583
All,2013 Q3,J,Information and communications,"Motion picture, video and television programme production, sound recording and music publishing; Programming and broadcasting",16163,9775,6388,307,2327
All,2013 Q3,J,Information and communications,Telecommunications,19455,12846,6609,704,332
All,2013 Q3,J,Information and communications,Information technology services,39744,30619,9125,1473,7029
All,2013 Q3,J,Information and communications,Information services,5791,3441,2350,184,764
All,2013 Q3,K,Financing and insurance,Financial services (except insurance and pension funding),131065,63870,67195,2647,7399
All,2013 Q3,K,Financing and insurance,Insurance,13773,5070,8703,407,153
All,2013 Q3,K,Financing and insurance,Services auxiliary to financial and insurance services,66092,33664,32428,2786,14562
All,2013 Q3,L,Real estate,Real estate,126041,79049,46992,3833,15100
All,2013 Q3,M,"Professional, scientific and technical services",Legal and accounting services,50007,22728,27279,608,7131
All,2013 Q3,M,"Professional, scientific and technical services",Activities of head offices; management and management consultancy services,33301,16211,17090,613,7167
All,2013 Q3,M,"Professional, scientific and technical services","Architecture and engineering services, technical testing and analysis",38873,25730,13143,1202,3193
All,2013 Q3,M,"Professional, scientific and technical services",Scientific research and development,2069,1469,600,119,151
All,2013 Q3,M,"Professional, scientific and technical services",Advertising and market research,14226,7481,6745,305,3614
All,2013 Q3,M,"Professional, scientific and technical services","Veterinary services; Other professional, scientific and technical services",22229,12463,9766,450,8297
All,2013 Q3,N,Administrative and support services,Rental and leasing services,2914,1702,1212,83,647
All,2013 Q3,N,Administrative and support services,Employment services,16385,7304,9081,480,2615
All,2013 Q3,N,Administrative and support services,"Travel agency, reservation service and related services",20429,7561,12868,515,2704
All,2013 Q3,N,Administrative and support services,Security and investigation services,45350,31082,14268,2349,213
All,2013 Q3,N,Administrative and support services,Services to buildings and landscape care,81663,26457,55206,1562,1670
All,2013 Q3,N,Administrative and support services,"Office administrative, office support and other business support services",20819,9890,10929,492,5176
All,2013 Q3,P,Education,Education,177137,65010,112127,3917,12304
All,2013 Q3,Q,Human health and social work services,Human health services,107595,28970,78625,3393,7466
All,2013 Q3,Q,Human health and social work services,Residential care services,27642,4391,23251,2193,1169
All,2013 Q3,Q,Human health and social work services,Social work services,30801,7636,23165,712,2047
All,2013 Q3,R,"Arts, entertainment and recreation",Creative and performing arts activities,3686,2087,1599,60,1465
All,2013 Q3,R,"Arts, entertainment and recreation","Libraries, archives, museums and other cultural activities",507,220,287,9,85
All,2013 Q3,R,"Arts, entertainment and recreation",Amusement parks and theme parks,6275,3435,2840,258,6
All,2013 Q3,R,"Arts, entertainment and recreation",Sports and other entertainment services,35186,16047,19139,1537,1308
All,2013 Q3,S,Other services,Activities of membership organisations,9893,4521,5372,340,1174
All,2013 Q3,S,Other services,"Repair of motor vehicles, motorcycles, computers, personal and household goods",18689,15985,2704,506,6457
All,2013 Q3,S,Other services,Other personal services,46345,14233,32112,2695,11359
All,2013 Q4,C,Manufacturing,Manufacture of food products,24039,12300,11739,836,943
All,2013 Q4,C,Manufacturing,Manufacture of beverages,2927,2227,700,56,30
All,2013 Q4,C,Manufacturing,Manufacture of tobacco products,586,385,201,31,3
All,2013 Q4,C,Manufacturing,Manufacture of textiles,4658,2472,2186,6,679
All,2013 Q4,C,Manufacturing,Manufacture of wearing apparel,8572,3348,5224,101,965
All,2013 Q4,C,Manufacturing,"Manufacture of leather and related products; Manufacture of wood and of products of wood and cork, articles of straw and plaiting materials (except furniture and toys)",456,301,155,26,144
All,2013 Q4,C,Manufacturing,Manufacture of paper and paper products,997,776,221,4,305
All,2013 Q4,C,Manufacturing,Printing and reproduction of recorded media,17043,11189,5854,89,2677
All,2013 Q4,C,Manufacturing,Manufacture of coke and refined petroleum products; Manufacture of chemicals and chemical products,1840,907,933,51,209
All,2013 Q4,C,Manufacturing,"Manufacture of pharmaceuticals, medicinal chemical and botanical products",4722,1939,2783,142,254
All,2013 Q4,C,Manufacturing,"Manufacture of rubber and plastics products (except furniture, toys, sports goods and stationery)",2331,1483,848,74,398
All,2013 Q4,C,Manufacturing,Manufacture of other non-metallic mineral products,1122,989,133,24,204
All,2013 Q4,C,Manufacturing,Manufacture of basic metals,1183,1008,175,7,87
All,2013 Q4,C,Manufacturing,Manufacture of fabricated metal products (except machinery and equipment),3192,2341,851,19,793
All,2013 Q4,C,Manufacturing,"Manufacture of computer, electronic and optical products",3861,2194,1667,172,324
All,2013 Q4,C,Manufacturing,Manufacture of electrical equipment,1865,1244,621,11,220
All,2013 Q4,C,Manufacturing,Manufacture of machinery and equipment n.e.c.,2049,1809,240,70,391
All,2013 Q4,C,Manufacturing,Body assembly of motor vehicles; Manufacture of other transport equipment,1028,994,34,6,85
All,2013 Q4,C,Manufacturing,Manufacture of furniture,471,349,122,17,158
All,2013 Q4,C,Manufacturing,Other manufacturing,7559,4694,2865,112,1387
All,2013 Q4,C,Manufacturing,Repair and installation of machinery and equipment,13182,11246,1936,533,1285
All,2013 Q4,B,Mining and quarrying,Quarrying and other mining of non-metal ores,78,68,10,0,2
All,2013 Q4,D,Electricity and gas supply,Electricity and gas supply,7671,6446,1225,72,8
All,2013 Q4,E,"Sewerage, waste management and remediation services",Sewerage,243,222,21,0,32
All,2013 Q4,E,"Sewerage, waste management and remediation services","Waste collection, treatment and disposal; materials recovery",3012,2089,923,98,372
All,2013 Q4,E,"Sewerage, waste management and remediation services",Remediation and other waste management services,30,30,0,0,5
All,2013 Q4,F,Construction,Construction sites (manual workers only),80061,72430,7631,1345,1309
All,2013 Q4,F,Construction,Public sector sites,35764,32985,2779,1040,502
All,2013 Q4,F,Construction,Public sector building sites,8487,7714,773,137,136
All,2013 Q4,F,Construction,Public sector civil engineering sites,27277,25271,2006,903,366
All,2013 Q4,F,Construction,Private sector sites,44297,39445,4852,305,807
All,2013 Q4,F,Construction,Private sector building sites,42719,37942,4777,271,699
All,2013 Q4,F,Construction,Private sector civil engineering sites,1578,1503,75,34,108
All,2013 Q4,G,"Import/export, wholesale and retail trades",Import and export trade,490308,254198,236110,7237,101796
All,2013 Q4,G,"Import/export, wholesale and retail trades",Wholesale,62515,37657,24858,1307,14480
All,2013 Q4,G,"Import/export, wholesale and retail trades",Retail trade,267703,104194,163509,8307,65387
All,2013 Q4,H,"Transportation, storage, postal and courier services",Land transport,44294,37784,6510,1371,2057
All,2013 Q4,H,"Transportation, storage, postal and courier services",Water transport,11270,6991,4279,134,407
All,2013 Q4,H,"Transportation, storage, postal and courier services",Air transport,25481,9799,15682,148,147
All,2013 Q4,H,"Transportation, storage, postal and courier services",Warehousing and support services for transportation,78554,47860,30694,1584,6457
All,2013 Q4,H,"Transportation, storage, postal and courier services",Postal and courier services,12021,7518,4503,393,633
All,2013 Q4,I,Accommodation and food services,Accommodation services,40585,21529,19056,1251,1148
All,2013 Q4,I,Accommodation and food services,Food and beverage services,237209,108283,128926,13708,15920
All,2013 Q4,J,Information and communications,Publishing,21338,11235,10103,214,1604
All,2013 Q4,J,Information and communications,"Motion picture, video and television programme production, sound recording and music publishing; Programming and broadcasting",16250,10315,5935,196,2343
All,2013 Q4,J,Information and communications,Telecommunications,19060,11695,7365,486,335
All,2013 Q4,J,Information and communications,Information technology services,40671,31116,9555,860,7139
All,2013 Q4,J,Information and communications,Information services,5929,3481,2448,239,803
All,2013 Q4,K,Financing and insurance,Financial services (except insurance and pension funding),132520,64392,68128,2466,7467
All,2013 Q4,K,Financing and insurance,Insurance,13862,5258,8604,453,157
All,2013 Q4,K,Financing and insurance,Services auxiliary to financial and insurance services,67108,34167,32941,1562,14892
All,2013 Q4,L,Real estate,Real estate,126523,78753,47770,3497,15198
All,2013 Q4,M,"Professional, scientific and technical services",Legal and accounting services,50641,23885,26756,575,7331
All,2013 Q4,M,"Professional, scientific and technical services",Activities of head offices; management and management consultancy services,33816,16625,17191,688,7453
All,2013 Q4,M,"Professional, scientific and technical services","Architecture and engineering services, technical testing and analysis",39697,27443,12254,1033,3266
All,2013 Q4,M,"Professional, scientific and technical services",Scientific research and development,2114,1498,616,130,151
All,2013 Q4,M,"Professional, scientific and technical services",Advertising and market research,14486,7686,6800,373,3669
All,2013 Q4,M,"Professional, scientific and technical services","Veterinary services; Other professional, scientific and technical services",23063,13631,9432,437,8649
All,2013 Q4,N,Administrative and support services,Rental and leasing services,2967,1701,1266,75,650
All,2013 Q4,N,Administrative and support services,Employment services,16721,7239,9482,495,2698
All,2013 Q4,N,Administrative and support services,"Travel agency, reservation service and related services",20855,7980,12875,533,2761
All,2013 Q4,N,Administrative and support services,Security and investigation services,46076,30973,15103,2130,215
All,2013 Q4,N,Administrative and support services,Services to buildings and landscape care,82147,28167,53980,1983,1696
All,2013 Q4,N,Administrative and support services,"Office administrative, office support and other business support services",21234,10065,11169,479,5297
All,2013 Q4,P,Education,Education,177734,66032,111702,3469,12549
All,2013 Q4,Q,Human health and social work services,Human health services,108469,29301,79168,1772,7592
All,2013 Q4,Q,Human health and social work services,Residential care services,27621,3630,23991,1765,1163
All,2013 Q4,Q,Human health and social work services,Social work services,30853,7996,22857,596,2058
All,2013 Q4,R,"Arts, entertainment and recreation",Creative and performing arts activities,3868,2329,1539,63,1559
All,2013 Q4,R,"Arts, entertainment and recreation","Libraries, archives, museums and other cultural activities",541,235,306,15,84
All,2013 Q4,R,"Arts, entertainment and recreation",Amusement parks and theme parks,5997,3258,2739,240,6
All,2013 Q4,R,"Arts, entertainment and recreation",Sports and other entertainment services,35594,18964,16630,2397,1318
All,2013 Q4,S,Other services,Activities of membership organisations,9998,4457,5541,254,1203
All,2013 Q4,S,Other services,"Repair of motor vehicles, motorcycles, computers, personal and household goods",19136,15661,3475,881,6527
All,2013 Q4,S,Other services,Other personal services,46277,14057,32220,2681,11503
All,2014 Q1,C,Manufacturing,Manufacture of food products,24858,13108,11750,961,972
All,2014 Q1,C,Manufacturing,Manufacture of beverages,2925,2268,657,40,30
All,2014 Q1,C,Manufacturing,Manufacture of tobacco products,562,381,181,44,3
All,2014 Q1,C,Manufacturing,Manufacture of textiles,4505,2246,2259,62,659
All,2014 Q1,C,Manufacturing,Manufacture of wearing apparel,8196,3136,5060,53,941
All,2014 Q1,C,Manufacturing,"Manufacture of leather and related products; Manufacture of wood and of products of wood and cork, articles of straw and plaiting materials (except furniture and toys)",461,318,143,32,148
All,2014 Q1,C,Manufacturing,Manufacture of paper and paper products,982,695,287,10,300
All,2014 Q1,C,Manufacturing,Printing and reproduction of recorded media,16750,10787,5963,136,2684
All,2014 Q1,C,Manufacturing,Manufacture of coke and refined petroleum products; Manufacture of chemicals and chemical products,1841,1092,749,44,208
All,2014 Q1,C,Manufacturing,"Manufacture of pharmaceuticals, medicinal chemical and botanical products",4460,1915,2545,107,251
All,2014 Q1,C,Manufacturing,"Manufacture of rubber and plastics products (except furniture, toys, sports goods and stationery)",2298,1298,1000,62,395
All,2014 Q1,C,Manufacturing,Manufacture of other non-metallic mineral products,1109,864,245,19,206
All,2014 Q1,C,Manufacturing,Manufacture of basic metals,1169,975,194,23,84
All,2014 Q1,C,Manufacturing,Manufacture of fabricated metal products (except machinery and equipment),2903,2344,559,84,765
All,2014 Q1,C,Manufacturing,"Manufacture of computer, electronic and optical products",3864,2157,1707,85,325
All,2014 Q1,C,Manufacturing,Manufacture of electrical equipment,1905,1197,708,46,212
All,2014 Q1,C,Manufacturing,Manufacture of machinery and equipment n.e.c.,1951,1598,353,60,381
All,2014 Q1,C,Manufacturing,Body assembly of motor vehicles; Manufacture of other transport equipment,910,858,52,11,86
All,2014 Q1,C,Manufacturing,Manufacture of furniture,458,356,102,5,159
All,2014 Q1,C,Manufacturing,Other manufacturing,8030,5126,2904,156,1480
All,2014 Q1,C,Manufacturing,Repair and installation of machinery and equipment,13361,11465,1896,1161,1285
All,2014 Q1,B,Mining and quarrying,Quarrying and other mining of non-metal ores,78,68,10,0,2
All,2014 Q1,D,Electricity and gas supply,Electricity and gas supply,7762,6467,1295,67,8
All,2014 Q1,E,"Sewerage, waste management and remediation services",Sewerage,244,212,32,8,33
All,2014 Q1,E,"Sewerage, waste management and remediation services","Waste collection, treatment and disposal; materials recovery",2978,1879,1099,199,392
All,2014 Q1,E,"Sewerage, waste management and remediation services",Remediation and other waste management services,29,26,3,0,5
All,2014 Q1,F,Construction,Construction sites (manual workers only),78570,70613,7957,1628,1296
All,2014 Q1,F,Construction,Public sector sites,33387,30621,2766,955,512
All,2014 Q1,F,Construction,Public sector building sites,8785,7906,879,115,143
All,2014 Q1,F,Construction,Public sector civil engineering sites,24602,22715,1887,840,369
All,2014 Q1,F,Construction,Private sector sites,45183,39992,5191,673,784
All,2014 Q1,F,Construction,Private sector building sites,43676,38571,5105,653,683
All,2014 Q1,F,Construction,Private sector civil engineering sites,1507,1421,86,20,101
All,2014 Q1,G,"Import/export, wholesale and retail trades",Import and export trade,490809,255761,235048,7970,102101
All,2014 Q1,G,"Import/export, wholesale and retail trades",Wholesale,62109,36554,25555,1238,14221
All,2014 Q1,G,"Import/export, wholesale and retail trades",Retail trade,269997,106459,163538,9681,65804
All,2014 Q1,H,"Transportation, storage, postal and courier services",Land transport,44375,38417,5958,1349,2064
All,2014 Q1,H,"Transportation, storage, postal and courier services",Water transport,11275,6787,4488,152,408
All,2014 Q1,H,"Transportation, storage, postal and courier services",Air transport,25702,9917,15785,172,146
All,2014 Q1,H,"Transportation, storage, postal and courier services",Warehousing and support services for transportation,78551,48475,30076,1985,6501
All,2014 Q1,H,"Transportation, storage, postal and courier services",Postal and courier services,11818,8716,3102,525,631
All,2014 Q1,I,Accommodation and food services,Accommodation services,40367,21249,19118,1727,1182
All,2014 Q1,I,Accommodation and food services,Food and beverage services,240863,110634,130229,15868,16272
All,2014 Q1,J,Information and communications,Publishing,21471,12209,9262,274,1628
All,2014 Q1,J,Information and communications,"Motion picture, video and television programme production, sound recording and music publishing; Programming and broadcasting",16040,9827,6213,262,2341
All,2014 Q1,J,Information and communications,Telecommunications,18209,10576,7633,439,318
All,2014 Q1,J,Information and communications,Information technology services,41174,31102,10072,1389,7195
All,2014 Q1,J,Information and communications,Information services,5971,3544,2427,203,805
All,2014 Q1,K,Financing and insurance,Financial services (except insurance and pension funding),131059,63150,67909,2116,7390
All,2014 Q1,K,Financing and insurance,Insurance,14803,6180,8623,411,155
All,2014 Q1,K,Financing and insurance,Services auxiliary to financial and insurance services,66928,34824,32104,1568,14918
All,2014 Q1,L,Real estate,Real estate,126951,77076,49875,3962,15117
All,2014 Q1,M,"Professional, scientific and technical services",Legal and accounting services,50802,23188,27614,738,7374
All,2014 Q1,M,"Professional, scientific and technical services",Activities of head offices; management and management consultancy services,33985,15914,18071,983,7467
All,2014 Q1,M,"Professional, scientific and technical services","Architecture and engineering services, technical testing and analysis",39428,25393,14035,1114,3260
All,2014 Q1,M,"Professional, scientific and technical services",Scientific research and development,2089,1546,543,166,150
All,2014 Q1,M,"Professional, scientific and technical services",Advertising and market research,14433,8046,6387,386,3678
All,2014 Q1,M,"Professional, scientific and technical services","Veterinary services; Other professional, scientific and technical services",23053,13340,9713,528,8675
All,2014 Q1,N,Administrative and support services,Rental and leasing services,3138,1933,1205,48,672
All,2014 Q1,N,Administrative and support services,Employment services,16654,7362,9292,460,2692
All,2014 Q1,N,Administrative and support services,"Travel agency, reservation service and related services",20277,7515,12762,536,2740
All,2014 Q1,N,Administrative and support services,Security and investigation services,46811,31901,14910,2572,216
All,2014 Q1,N,Administrative and support services,Services to buildings and landscape care,81559,26577,54982,1645,1672
All,2014 Q1,N,Administrative and support services,"Office administrative, office support and other business support services",21317,9863,11454,591,5271
All,2014 Q1,P,Education,Education,181796,67212,114584,3333,12917
All,2014 Q1,Q,Human health and social work services,Human health services,109754,30036,79718,1462,7612
All,2014 Q1,Q,Human health and social work services,Residential care services,27800,4026,23774,2042,1166
All,2014 Q1,Q,Human health and social work services,Social work services,30961,8768,22193,525,2042
All,2014 Q1,R,"Arts, entertainment and recreation",Creative and performing arts activities,4034,2156,1878,97,1631
All,2014 Q1,R,"Arts, entertainment and recreation","Libraries, archives, museums and other cultural activities",595,232,363,11,84
All,2014 Q1,R,"Arts, entertainment and recreation",Amusement parks and theme parks,5485,2977,2508,229,6
All,2014 Q1,R,"Arts, entertainment and recreation",Sports and other entertainment services,39449,20298,19151,642,1307
All,2014 Q1,S,Other services,Activities of membership organisations,10022,4085,5937,276,1204
All,2014 Q1,S,Other services,"Repair of motor vehicles, motorcycles, computers, personal and household goods",18832,15551,3281,616,6440
All,2014 Q1,S,Other services,Other personal services,46837,13891,32946,2391,11628
All,2014 Q2,C,Manufacturing,Manufacture of food products,25299,12897,12402,1531,1035
All,2014 Q2,C,Manufacturing,Manufacture of beverages,2999,2317,682,30,30
All,2014 Q2,C,Manufacturing,Manufacture of tobacco products,497,340,157,31,3
All,2014 Q2,C,Manufacturing,Manufacture of textiles,4259,2178,2081,12,638
All,2014 Q2,C,Manufacturing,Manufacture of wearing apparel,7511,3399,4112,36,933
All,2014 Q2,C,Manufacturing,"Manufacture of leather and related products; Manufacture of wood and of products of wood and cork, articles of straw and plaiting materials (except furniture and toys)",468,322,146,24,151
All,2014 Q2,C,Manufacturing,Manufacture of paper and paper products,963,687,276,31,292
All,2014 Q2,C,Manufacturing,Printing and reproduction of recorded media,16373,10698,5675,335,2644
All,2014 Q2,C,Manufacturing,Manufacture of coke and refined petroleum products; Manufacture of chemicals and chemical products,1988,1259,729,91,206
All,2014 Q2,C,Manufacturing,"Manufacture of pharmaceuticals, medicinal chemical and botanical products",4707,1797,2910,97,245
All,2014 Q2,C,Manufacturing,"Manufacture of rubber and plastics products (except furniture, toys, sports goods and stationery)",2128,1456,672,46,359
All,2014 Q2,C,Manufacturing,Manufacture of other non-metallic mineral products,1113,925,188,16,205
All,2014 Q2,C,Manufacturing,Manufacture of basic metals,1177,954,223,52,84
All,2014 Q2,C,Manufacturing,Manufacture of fabricated metal products (except machinery and equipment),2893,2175,718,10,768
All,2014 Q2,C,Manufacturing,"Manufacture of computer, electronic and optical products",3832,2054,1778,61,325
All,2014 Q2,C,Manufacturing,Manufacture of electrical equipment,1892,1318,574,45,215
All,2014 Q2,C,Manufacturing,Manufacture of machinery and equipment n.e.c.,1845,1538,307,78,373
All,2014 Q2,C,Manufacturing,Body assembly of motor vehicles; Manufacture of other transport equipment,795,732,63,15,83
All,2014 Q2,C,Manufacturing,Manufacture of furniture,447,364,83,4,157
All,2014 Q2,C,Manufacturing,Other manufacturing,7705,4847,2858,116,1444
All,2014 Q2,C,Manufacturing,Repair and installation of machinery and equipment,13331,11201,2130,922,1280
All,2014 Q2,B,Mining and quarrying,Quarrying and other mining of non-metal ores,82,71,11,0,2
All,2014 Q2,D,Electricity and gas supply,Electricity and gas supply,7803,6441,1362,62,8
All,2014 Q2,E,"Sewerage, waste management and remediation services",Sewerage,263,235,28,13,33
All,2014 Q2,E,"Sewerage, waste management and remediation services","Waste collection, treatment and disposal; materials recovery",2876,1806,1070,267,387
All,2014 Q2,E,"Sewerage, waste management and remediation services",Remediation and other waste management services,25,21,4,0,5
All,2014 Q2,F,Construction,Construction sites (manual workers only),79734,72770,6964,1535,1314
All,2014 Q2,F,Construction,Public sector sites,36349,33711,2638,1060,538
All,2014 Q2,F,Construction,Public sector building sites,9932,9023,909,120,156
All,2014 Q2,F,Construction,Public sector civil engineering sites,26417,24688,1729,940,382
All,2014 Q2,F,Construction,Private sector sites,43385,39059,4326,475,776
All,2014 Q2,F,Construction,Private sector building sites,41792,37534,4258,464,672
All,2014 Q2,F,Construction,Private sector civil engineering sites,1593,1525,68,11,104
All,2014 Q2,G,"Import/export, wholesale and retail trades",Import and export trade,491632,255621,236011,6974,102249
All,2014 Q2,G,"Import/export, wholesale and retail trades",Wholesale,62461,37171,25290,1178,14277
All,2014 Q2,G,"Import/export, wholesale and retail trades",Retail trade,271904,107342,164562,8805,65936
All,2014 Q2,H,"Transportation, storage, postal and courier services",Land transport,44784,38148,6636,1148,2038
All,2014 Q2,H,"Transportation, storage, postal and courier services",Water transport,11427,7331,4096,137,412
All,2014 Q2,H,"Transportation, storage, postal and courier services",Air transport,25737,9612,16125,231,148
All,2014 Q2,H,"Transportation, storage, postal and courier services",Warehousing and support services for transportation,79399,48548,30851,1876,6544
All,2014 Q2,H,"Transportation, storage, postal and courier services",Postal and courier services,13200,9822,3378,645,657
All,2014 Q2,I,Accommodation and food services,Accommodation services,40300,21334,18966,1809,1212
All,2014 Q2,I,Accommodation and food services,Food and beverage services,242854,114108,128746,13990,16584
All,2014 Q2,J,Information and communications,Publishing,21453,12074,9379,299,1629
All,2014 Q2,J,Information and communications,"Motion picture, video and television programme production, sound recording and music publishing; Programming and broadcasting",16245,9405,6840,257,2338
All,2014 Q2,J,Information and communications,Telecommunications,18047,11570,6477,602,311
All,2014 Q2,J,Information and communications,Information technology services,41723,31728,9995,1257,7312
All,2014 Q2,J,Information and communications,Information services,6049,3762,2287,238,824
All,2014 Q2,K,Financing and insurance,Financial services (except insurance and pension funding),131589,63733,67856,2510,7345
All,2014 Q2,K,Financing and insurance,Insurance,15494,6320,9174,402,157
All,2014 Q2,K,Financing and insurance,Services auxiliary to financial and insurance services,66911,34532,32379,2092,14801
All,2014 Q2,L,Real estate,Real estate,126624,77577,49047,3851,15050
All,2014 Q2,M,"Professional, scientific and technical services",Legal and accounting services,50659,23094,27565,648,7350
All,2014 Q2,M,"Professional, scientific and technical services",Activities of head offices; management and management consultancy services,33799,16397,17402,921,7449
All,2014 Q2,M,"Professional, scientific and technical services","Architecture and engineering services, technical testing and analysis",39588,26504,13084,1141,3256
All,2014 Q2,M,"Professional, scientific and technical services",Scientific research and development,2070,1473,597,155,145
All,2014 Q2,M,"Professional, scientific and technical services",Advertising and market research,14274,7866,6408,272,3639
All,2014 Q2,M,"Professional, scientific and technical services","Veterinary services; Other professional, scientific and technical services",22880,13337,9543,479,8604
All,2014 Q2,N,Administrative and support services,Rental and leasing services,3145,1824,1321,74,684
All,2014 Q2,N,Administrative and support services,Employment services,17068,7451,9617,439,2682
All,2014 Q2,N,Administrative and support services,"Travel agency, reservation service and related services",20349,7872,12477,587,2743
All,2014 Q2,N,Administrative and support services,Security and investigation services,46871,31116,15755,2216,216
All,2014 Q2,N,Administrative and support services,Services to buildings and landscape care,81794,28356,53438,2025,1684
All,2014 Q2,N,Administrative and support services,"Office administrative, office support and other business support services",20869,9824,11045,399,5179
All,2014 Q2,P,Education,Education,184238,68015,116223,3809,13329
All,2014 Q2,Q,Human health and social work services,Human health services,110252,29904,80348,4096,7678
All,2014 Q2,Q,Human health and social work services,Residential care services,28058,4135,23923,2365,1161
All,2014 Q2,Q,Human health and social work services,Social work services,31082,8125,22957,615,2051
All,2014 Q2,R,"Arts, entertainment and recreation",Creative and performing arts activities,4148,2328,1820,113,1682
All,2014 Q2,R,"Arts, entertainment and recreation","Libraries, archives, museums and other cultural activities",593,218,375,15,85
All,2014 Q2,R,"Arts, entertainment and recreation",Amusement parks and theme parks,5967,3265,2702,294,6
All,2014 Q2,R,"Arts, entertainment and recreation",Sports and other entertainment services,39696,20053,19643,1813,1308
All,2014 Q2,S,Other services,Activities of membership organisations,10076,4662,5414,172,1217
All,2014 Q2,S,Other services,"Repair of motor vehicles, motorcycles, computers, personal and household goods",18867,15614,3253,727,6481
All,2014 Q2,S,Other services,Other personal services,47010,13504,33506,2585,11684
All,2014 Q3,C,Manufacturing,Manufacture of food products,25444,12251,13193,890,1084
All,2014 Q3,C,Manufacturing,Manufacture of beverages,3002,2308,694,65,30
All,2014 Q3,C,Manufacturing,Manufacture of tobacco products,493,337,156,36,3
All,2014 Q3,C,Manufacturing,Manufacture of textiles,4149,2373,1776,20,609
All,2014 Q3,C,Manufacturing,Manufacture of wearing apparel,6701,2582,4119,104,862
All,2014 Q3,C,Manufacturing,"Manufacture of leather and related products; Manufacture of wood and of products of wood and cork, articles of straw and plaiting materials (except furniture and toys)",487,335,152,43,146
All,2014 Q3,C,Manufacturing,Manufacture of paper and paper products,918,666,252,28,281
All,2014 Q3,C,Manufacturing,Printing and reproduction of recorded media,16366,10857,5509,434,2543
All,2014 Q3,C,Manufacturing,Manufacture of coke and refined petroleum products; Manufacture of chemicals and chemical products,1972,1052,920,43,210
All,2014 Q3,C,Manufacturing,"Manufacture of pharmaceuticals, medicinal chemical and botanical products",4874,2052,2822,119,249
All,2014 Q3,C,Manufacturing,"Manufacture of rubber and plastics products (except furniture, toys, sports goods and stationery)",2397,1728,669,41,355
All,2014 Q3,C,Manufacturing,Manufacture of other non-metallic mineral products,1178,956,222,21,204
All,2014 Q3,C,Manufacturing,Manufacture of basic metals,1150,809,341,22,80
All,2014 Q3,C,Manufacturing,Manufacture of fabricated metal products (except machinery and equipment),2984,2263,721,103,759
All,2014 Q3,C,Manufacturing,"Manufacture of computer, electronic and optical products",3831,2251,1580,53,313
All,2014 Q3,C,Manufacturing,Manufacture of electrical equipment,1847,1196,651,28,216
All,2014 Q3,C,Manufacturing,Manufacture of machinery and equipment n.e.c.,1996,1661,335,59,364
All,2014 Q3,C,Manufacturing,Body assembly of motor vehicles; Manufacture of other transport equipment,685,565,120,35,79
All,2014 Q3,C,Manufacturing,Manufacture of furniture,448,342,106,7,153
All,2014 Q3,C,Manufacturing,Other manufacturing,7904,4945,2959,182,1390
All,2014 Q3,C,Manufacturing,Repair and installation of machinery and equipment,13816,11708,2108,546,1289
All,2014 Q3,B,Mining and quarrying,Quarrying and other mining of non-metal ores,81,70,11,0,2
All,2014 Q3,D,Electricity and gas supply,Electricity and gas supply,7888,6507,1381,75,8
All,2014 Q3,E,"Sewerage, waste management and remediation services",Sewerage,261,231,30,3,32
All,2014 Q3,E,"Sewerage, waste management and remediation services","Waste collection, treatment and disposal; materials recovery",2827,1718,1109,142,373
All,2014 Q3,E,"Sewerage, waste management and remediation services",Remediation and other waste management services,25,23,2,0,5
All,2014 Q3,F,Construction,Construction sites (manual workers only),86534,78228,8306,1532,1342
All,2014 Q3,F,Construction,Public sector sites,39460,37249,2211,873,530
All,2014 Q3,F,Construction,Public sector building sites,11911,10820,1091,228,150
All,2014 Q3,F,Construction,Public sector civil engineering sites,27549,26429,1120,645,380
All,2014 Q3,F,Construction,Private sector sites,47074,40979,6095,659,812
All,2014 Q3,F,Construction,Private sector building sites,45658,39638,6020,639,713
All,2014 Q3,F,Construction,Private sector civil engineering sites,1416,1341,75,20,99
All,2014 Q3,G,"Import/export, wholesale and retail trades",Import and export trade,491911,253645,238266,7203,102384
All,2014 Q3,G,"Import/export, wholesale and retail trades",Wholesale,62520,36315,26205,1244,14255
All,2014 Q3,G,"Import/export, wholesale and retail trades",Retail trade,269813,108845,160968,9239,65788
All,2014 Q3,H,"Transportation, storage, postal and courier services",Land transport,45086,38393,6693,781,2016
All,2014 Q3,H,"Transportation, storage, postal and courier services",Water transport,11730,7276,4454,163,394
All,2014 Q3,H,"Transportation, storage, postal and courier services",Air transport,26299,10002,16297,198,149
All,2014 Q3,H,"Transportation, storage, postal and courier services",Warehousing and support services for transportation,79783,49961,29822,1938,6524
All,2014 Q3,H,"Transportation, storage, postal and courier services",Postal and courier services,12551,9235,3316,304,645
All,2014 Q3,I,Accommodation and food services,Accommodation services,39848,21273,18575,1494,1155
All,2014 Q3,I,Accommodation and food services,Food and beverage services,243102,111502,131600,14052,16525
All,2014 Q3,J,Information and communications,Publishing,21259,11461,9798,328,1613
All,2014 Q3,J,Information and communications,"Motion picture, video and television programme production, sound recording and music publishing; Programming and broadcasting",16349,10051,6298,231,2335
All,2014 Q3,J,Information and communications,Telecommunications,19204,12014,7190,455,306
All,2014 Q3,J,Information and communications,Information technology services,41922,31440,10482,1167,7338
All,2014 Q3,J,Information and communications,Information services,6053,3643,2410,177,831
All,2014 Q3,K,Financing and insurance,Financial services (except insurance and pension funding),133994,65671,68323,2633,7313
All,2014 Q3,K,Financing and insurance,Insurance,14720,5710,9010,373,157
All,2014 Q3,K,Financing and insurance,Services auxiliary to financial and insurance services,65957,33920,32037,1870,14703
All,2014 Q3,L,Real estate,Real estate,126777,76126,50651,4394,14954
All,2014 Q3,M,"Professional, scientific and technical services",Legal and accounting services,50455,22148,28307,635,7295
All,2014 Q3,M,"Professional, scientific and technical services",Activities of head offices; management and management consultancy services,33588,16113,17475,804,7374
All,2014 Q3,M,"Professional, scientific and technical services","Architecture and engineering services, technical testing and analysis",39391,26274,13117,1165,3218
All,2014 Q3,M,"Professional, scientific and technical services",Scientific research and development,2064,1495,569,110,143
All,2014 Q3,M,"Professional, scientific and technical services",Advertising and market research,14252,7298,6954,337,3617
All,2014 Q3,M,"Professional, scientific and technical services","Veterinary services; Other professional, scientific and technical services",22615,12948,9667,405,8478
All,2014 Q3,N,Administrative and support services,Rental and leasing services,3117,1899,1218,54,657
All,2014 Q3,N,Administrative and support services,Employment services,16805,7957,8848,372,2627
All,2014 Q3,N,Administrative and support services,"Travel agency, reservation service and related services",20347,7635,12712,460,2742
All,2014 Q3,N,Administrative and support services,Security and investigation services,47836,31705,16131,2138,223
All,2014 Q3,N,Administrative and support services,Services to buildings and landscape care,81924,26136,55788,1731,1679
All,2014 Q3,N,Administrative and support services,"Office administrative, office support and other business support services",20710,10356,10354,333,5128
All,2014 Q3,P,Education,Education,184852,67235,117617,3367,13607
All,2014 Q3,Q,Human health and social work services,Human health services,111538,30437,81101,2697,7748
All,2014 Q3,Q,Human health and social work services,Residential care services,28108,3833,24275,2149,1157
All,2014 Q3,Q,Human health and social work services,Social work services,30879,8979,21900,649,2036
All,2014 Q3,R,"Arts, entertainment and recreation",Creative and performing arts activities,4289,2565,1724,97,1777
All,2014 Q3,R,"Arts, entertainment and recreation","Libraries, archives, museums and other cultural activities",588,240,348,11,83
All,2014 Q3,R,"Arts, entertainment and recreation",Amusement parks and theme parks,6401,3534,2867,286,6
All,2014 Q3,R,"Arts, entertainment and recreation",Sports and other entertainment services,39727,20497,19230,1340,1311
All,2014 Q3,S,Other services,Activities of membership organisations,10164,4933,5231,298,1237
All,2014 Q3,S,Other services,"Repair of motor vehicles, motorcycles, computers, personal and household goods",18808,15268,3540,487,6484
All,2014 Q3,S,Other services,Other personal services,47105,13404,33701,2548,11696
All,2014 Q4,C,Manufacturing,Manufacture of food products,25101,12500,12601,977,1078
All,2014 Q4,C,Manufacturing,Manufacture of beverages,3028,2306,722,65,30
All,2014 Q4,C,Manufacturing,Manufacture of tobacco products,553,359,194,32,3
All,2014 Q4,C,Manufacturing,Manufacture of textiles,4035,2137,1898,13,593
All,2014 Q4,C,Manufacturing,Manufacture of wearing apparel,6306,2301,4005,31,842
All,2014 Q4,C,Manufacturing,"Manufacture of leather and related products; Manufacture of wood and of products of wood and cork, articles of straw and plaiting materials (except furniture and toys)",479,338,141,29,144
All,2014 Q4,C,Manufacturing,Manufacture of paper and paper products,910,651,259,12,279
All,2014 Q4,C,Manufacturing,Printing and reproduction of recorded media,16240,11234,5006,256,2521
All,2014 Q4,C,Manufacturing,Manufacture of coke and refined petroleum products; Manufacture of chemicals and chemical products,1945,1148,797,22,207
All,2014 Q4,C,Manufacturing,"Manufacture of pharmaceuticals, medicinal chemical and botanical products",4759,1863,2896,53,247
All,2014 Q4,C,Manufacturing,"Manufacture of rubber and plastics products (except furniture, toys, sports goods and stationery)",2383,1361,1022,37,351
All,2014 Q4,C,Manufacturing,Manufacture of other non-metallic mineral products,1189,974,215,46,205
All,2014 Q4,C,Manufacturing,Manufacture of basic metals,1140,939,201,16,78
All,2014 Q4,C,Manufacturing,Manufacture of fabricated metal products (except machinery and equipment),2916,2294,622,61,752
All,2014 Q4,C,Manufacturing,"Manufacture of computer, electronic and optical products",3922,2062,1860,62,309
All,2014 Q4,C,Manufacturing,Manufacture of electrical equipment,1817,1290,527,9,208
All,2014 Q4,C,Manufacturing,Manufacture of machinery and equipment n.e.c.,1874,1700,174,104,351
All,2014 Q4,C,Manufacturing,Body assembly of motor vehicles; Manufacture of other transport equipment,587,484,103,6,76
All,2014 Q4,C,Manufacturing,Manufacture of furniture,489,336,153,18,150
All,2014 Q4,C,Manufacturing,Other manufacturing,7495,4479,3016,138,1349
All,2014 Q4,C,Manufacturing,Repair and installation of machinery and equipment,14312,12045,2267,516,1283
All,2014 Q4,B,Mining and quarrying,Quarrying and other mining of non-metal ores,80,68,12,0,2
All,2014 Q4,D,Electricity and gas supply,Electricity and gas supply,7841,6453,1388,81,8
All,2014 Q4,E,"Sewerage, waste management and remediation services",Sewerage,259,172,87,3,32
All,2014 Q4,E,"Sewerage, waste management and remediation services","Waste collection, treatment and disposal; materials recovery",2931,2126,805,173,378
All,2014 Q4,E,"Sewerage, waste management and remediation services",Remediation and other waste management services,8,6,2,0,4
All,2014 Q4,F,Construction,Construction sites (manual workers only),86343,77641,8702,846,1261
All,2014 Q4,F,Construction,Public sector sites,40232,36718,3514,501,514
All,2014 Q4,F,Construction,Public sector building sites,14219,12842,1377,143,150
All,2014 Q4,F,Construction,Public sector civil engineering sites,26013,23876,2137,358,364
All,2014 Q4,F,Construction,Private sector sites,46111,40923,5188,345,747
All,2014 Q4,F,Construction,Private sector building sites,44971,39843,5128,341,666
All,2014 Q4,F,Construction,Private sector civil engineering sites,1140,1080,60,4,81
All,2014 Q4,G,"Import/export, wholesale and retail trades",Import and export trade,494115,253724,240391,6793,103864
All,2014 Q4,G,"Import/export, wholesale and retail trades",Wholesale,62070,36564,25506,1249,14055
All,2014 Q4,G,"Import/export, wholesale and retail trades",Retail trade,271553,107830,163723,8711,65921
All,2014 Q4,H,"Transportation, storage, postal and courier services",Land transport,45626,38724,6902,821,1975
All,2014 Q4,H,"Transportation, storage, postal and courier services",Water transport,11658,6876,4782,186,408
All,2014 Q4,H,"Transportation, storage, postal and courier services",Air transport,26324,9861,16463,210,149
All,2014 Q4,H,"Transportation, storage, postal and courier services",Warehousing and support services for transportation,79977,49592,30385,1396,6566
All,2014 Q4,H,"Transportation, storage, postal and courier services",Postal and courier services,13053,9493,3560,502,659
All,2014 Q4,I,Accommodation and food services,Accommodation services,40596,21294,19302,1466,1191
All,2014 Q4,I,Accommodation and food services,Food and beverage services,244958,113665,131293,13831,16683
All,2014 Q4,J,Information and communications,Publishing,21190,11302,9888,292,1611
All,2014 Q4,J,Information and communications,"Motion picture, video and television programme production, sound recording and music publishing; Programming and broadcasting",16315,10112,6203,346,2363
All,2014 Q4,J,Information and communications,Telecommunications,19255,12111,7144,356,306
All,2014 Q4,J,Information and communications,Information technology services,42352,31211,11141,1377,7458
All,2014 Q4,J,Information and communications,Information services,6103,3259,2844,301,857
All,2014 Q4,K,Financing and insurance,Financial services (except insurance and pension funding),135830,66433,69397,2350,7393
All,2014 Q4,K,Financing and insurance,Insurance,14549,5716,8833,402,159
All,2014 Q4,K,Financing and insurance,Services auxiliary to financial and insurance services,66870,33722,33148,1975,15171
All,2014 Q4,L,Real estate,Real estate,128773,76614,52159,3910,15296
All,2014 Q4,M,"Professional, scientific and technical services",Legal and accounting services,51167,23140,28027,741,7518
All,2014 Q4,M,"Professional, scientific and technical services",Activities of head offices; management and management consultancy services,34586,17288,17298,728,7724
All,2014 Q4,M,"Professional, scientific and technical services","Architecture and engineering services, technical testing and analysis",39836,27030,12806,1070,3264
All,2014 Q4,M,"Professional, scientific and technical services",Scientific research and development,2071,1522,549,101,149
All,2014 Q4,M,"Professional, scientific and technical services",Advertising and market research,14318,8106,6212,292,3662
All,2014 Q4,M,"Professional, scientific and technical services","Veterinary services; Other professional, scientific and technical services",23320,12896,10424,563,8873
All,2014 Q4,N,Administrative and support services,Rental and leasing services,3183,1923,1260,72,653
All,2014 Q4,N,Administrative and support services,Employment services,17287,7821,9466,479,2706
All,2014 Q4,N,Administrative and support services,"Travel agency, reservation service and related services",20571,8575,11996,627,2787
All,2014 Q4,N,Administrative and support services,Security and investigation services,48219,31753,16466,2241,230
All,2014 Q4,N,Administrative and support services,Services to buildings and landscape care,82717,26481,56236,1932,1741
All,2014 Q4,N,Administrative and support services,"Office administrative, office support and other business support services",20853,9458,11395,321,5177
All,2014 Q4,P,Education,Education,188373,70391,117982,3724,13916
All,2014 Q4,Q,Human health and social work services,Human health services,113477,30897,82580,1631,7864
All,2014 Q4,Q,Human health and social work services,Residential care services,28801,4267,24534,2411,1152
All,2014 Q4,Q,Human health and social work services,Social work services,31090,7962,23128,766,2030
All,2014 Q4,R,"Arts, entertainment and recreation",Creative and performing arts activities,4409,2404,2005,81,1829
All,2014 Q4,R,"Arts, entertainment and recreation","Libraries, archives, museums and other cultural activities",564,256,308,31,81
All,2014 Q4,R,"Arts, entertainment and recreation",Amusement parks and theme parks,6618,3570,3048,268,8
All,2014 Q4,R,"Arts, entertainment and recreation",Sports and other entertainment services,40233,20231,20002,1414,1327
All,2014 Q4,S,Other services,Activities of membership organisations,10110,4322,5788,277,1237
All,2014 Q4,S,Other services,"Repair of motor vehicles, motorcycles, computers, personal and household goods",19341,15688,3653,886,6552
All,2014 Q4,S,Other services,Other personal services,47951,13776,34175,2789,11795
All,2015 Q1,C,Manufacturing,Manufacture of food products,25131,10967,14164,1036,1104
All,2015 Q1,C,Manufacturing,Manufacture of beverages,3073,2350,723,55,30
All,2015 Q1,C,Manufacturing,Manufacture of tobacco products,564,373,191,90,3
All,2015 Q1,C,Manufacturing,Manufacture of textiles,3887,2057,1830,13,569
All,2015 Q1,C,Manufacturing,Manufacture of wearing apparel,6266,2422,3844,104,825
All,2015 Q1,C,Manufacturing,"Manufacture of leather and related products; Manufacture of wood and of products of wood and cork, articles of straw and plaiting materials (except furniture and toys)",466,332,134,22,141
All,2015 Q1,C,Manufacturing,Manufacture of paper and paper products,895,642,253,2,273
All,2015 Q1,C,Manufacturing,Printing and reproduction of recorded media,15866,9977,5889,186,2513
All,2015 Q1,C,Manufacturing,Manufacture of coke and refined petroleum products; Manufacture of chemicals and chemical products,1964,1470,494,27,205
All,2015 Q1,C,Manufacturing,"Manufacture of pharmaceuticals, medicinal chemical and botanical products",4665,2159,2506,138,248
All,2015 Q1,C,Manufacturing,"Manufacture of rubber and plastics products (except furniture, toys, sports goods and stationery)",2355,1569,786,72,336
All,2015 Q1,C,Manufacturing,Manufacture of other non-metallic mineral products,1236,1088,148,23,197
All,2015 Q1,C,Manufacturing,Manufacture of basic metals,1102,900,202,59,75
All,2015 Q1,C,Manufacturing,Manufacture of fabricated metal products (except machinery and equipment),2993,2373,620,52,751
All,2015 Q1,C,Manufacturing,"Manufacture of computer, electronic and optical products",3846,2046,1800,74,294
All,2015 Q1,C,Manufacturing,Manufacture of electrical equipment,1656,1151,505,40,200
All,2015 Q1,C,Manufacturing,Manufacture of machinery and equipment n.e.c.,1780,1575,205,30,339
All,2015 Q1,C,Manufacturing,Body assembly of motor vehicles; Manufacture of other transport equipment,520,450,70,11,76
All,2015 Q1,C,Manufacturing,Manufacture of furniture,458,324,134,7,151
All,2015 Q1,C,Manufacturing,Other manufacturing,7476,4900,2576,104,1336
All,2015 Q1,C,Manufacturing,Repair and installation of machinery and equipment,14101,11863,2238,844,1281
All,2015 Q1,B,Mining and quarrying,Quarrying and other mining of non-metal ores,78,66,12,0,2
All,2015 Q1,D,Electricity and gas supply,Electricity and gas supply,7817,6417,1400,95,8
All,2015 Q1,E,"Sewerage, waste management and remediation services",Sewerage,243,190,53,4,30
All,2015 Q1,E,"Sewerage, waste management and remediation services","Waste collection, treatment and disposal; materials recovery",2808,1972,836,203,363
All,2015 Q1,E,"Sewerage, waste management and remediation services",Remediation and other waste management services,6,5,1,0,4
All,2015 Q1,F,Construction,Construction sites (manual workers only),91878,82814,9064,882,1244
All,2015 Q1,F,Construction,Public sector sites,43188,39933,3255,546,502
All,2015 Q1,F,Construction,Public sector building sites,15662,14274,1388,174,152
All,2015 Q1,F,Construction,Public sector civil engineering sites,27526,25659,1867,372,350
All,2015 Q1,F,Construction,Private sector sites,48690,42881,5809,336,742
All,2015 Q1,F,Construction,Private sector building sites,47272,41539,5733,325,667
All,2015 Q1,F,Construction,Private sector civil engineering sites,1418,1342,76,11,75
All,2015 Q1,G,"Import/export, wholesale and retail trades",Import and export trade,487717,253360,234357,7622,103552
All,2015 Q1,G,"Import/export, wholesale and retail trades",Wholesale,61509,37713,23796,1377,13894
All,2015 Q1,G,"Import/export, wholesale and retail trades",Retail trade,271530,110030,161500,8553,65899
All,2015 Q1,H,"Transportation, storage, postal and courier services",Land transport,45443,39160,6283,1057,1941
All,2015 Q1,H,"Transportation, storage, postal and courier services",Water transport,11621,7293,4328,180,401
All,2015 Q1,H,"Transportation, storage, postal and courier services",Air transport,26783,10192,16591,425,151
All,2015 Q1,H,"Transportation, storage, postal and courier services",Warehousing and support services for transportation,79910,48967,30943,1697,6586
All,2015 Q1,H,"Transportation, storage, postal and courier services",Postal and courier services,12836,8983,3853,599,668
All,2015 Q1,I,Accommodation and food services,Accommodation services,40203,21319,18884,1880,1203
All,2015 Q1,I,Accommodation and food services,Food and beverage services,243475,109554,133921,13589,16575
All,2015 Q1,J,Information and communications,Publishing,20999,11283,9716,267,1609
All,2015 Q1,J,Information and communications,"Motion picture, video and television programme production, sound recording and music publishing; Programming and broadcasting",16370,9800,6570,392,2379
All,2015 Q1,J,Information and communications,Telecommunications,18177,11148,7029,627,305
All,2015 Q1,J,Information and communications,Information technology services,42439,32137,10302,1415,7569
All,2015 Q1,J,Information and communications,Information services,6064,3592,2472,232,854
All,2015 Q1,K,Financing and insurance,Financial services (except insurance and pension funding),136480,66670,69810,2637,7470
All,2015 Q1,K,Financing and insurance,Insurance,14641,5715,8926,374,162
All,2015 Q1,K,Financing and insurance,Services auxiliary to financial and insurance services,67626,34352,33274,1638,15456
All,2015 Q1,L,Real estate,Real estate,129770,78696,51074,4370,15531
All,2015 Q1,M,"Professional, scientific and technical services",Legal and accounting services,51740,23379,28361,816,7663
All,2015 Q1,M,"Professional, scientific and technical services",Activities of head offices; management and management consultancy services,34766,17172,17594,843,7976
All,2015 Q1,M,"Professional, scientific and technical services","Architecture and engineering services, technical testing and analysis",40297,26907,13390,1032,3312
All,2015 Q1,M,"Professional, scientific and technical services",Scientific research and development,2084,1526,558,93,152
All,2015 Q1,M,"Professional, scientific and technical services",Advertising and market research,14488,7769,6719,351,3703
All,2015 Q1,M,"Professional, scientific and technical services","Veterinary services; Other professional, scientific and technical services",23623,13724,9899,559,9087
All,2015 Q1,N,Administrative and support services,Rental and leasing services,3262,1889,1373,96,672
All,2015 Q1,N,Administrative and support services,Employment services,17827,7721,10106,639,2762
All,2015 Q1,N,Administrative and support services,"Travel agency, reservation service and related services",20811,8313,12498,535,2868
All,2015 Q1,N,Administrative and support services,Security and investigation services,48611,32699,15912,2058,234
All,2015 Q1,N,Administrative and support services,Services to buildings and landscape care,84209,27039,57170,1874,1756
All,2015 Q1,N,Administrative and support services,"Office administrative, office support and other business support services",21154,10378,10776,448,5293
All,2015 Q1,P,Education,Education,190841,69443,121398,3531,13995
All,2015 Q1,Q,Human health and social work services,Human health services,114834,31457,83377,3151,7939
All,2015 Q1,Q,Human health and social work services,Residential care services,29186,4410,24776,2382,1141
All,2015 Q1,Q,Human health and social work services,Social work services,31138,7100,24038,924,2000
All,2015 Q1,R,"Arts, entertainment and recreation",Creative and performing arts activities,4451,2394,2057,79,1876
All,2015 Q1,R,"Arts, entertainment and recreation","Libraries, archives, museums and other cultural activities",597,254,343,43,82
All,2015 Q1,R,"Arts, entertainment and recreation",Amusement parks and theme parks,5972,3247,2725,279,7
All,2015 Q1,R,"Arts, entertainment and recreation",Sports and other entertainment services,39485,19995,19490,1573,1333
All,2015 Q1,S,Other services,Activities of membership organisations,10346,4558,5788,356,1243
All,2015 Q1,S,Other services,"Repair of motor vehicles, motorcycles, computers, personal and household goods",19457,16324,3133,654,6609
All,2015 Q1,S,Other services,Other personal services,47794,12187,35607,2644,11830
All,2015 Q2,C,Manufacturing,Manufacture of food products,25240,11699,13541,817,1114
All,2015 Q2,C,Manufacturing,Manufacture of beverages,3067,2338,729,61,30
All,2015 Q2,C,Manufacturing,Manufacture of tobacco products,589,380,209,75,3
All,2015 Q2,C,Manufacturing,Manufacture of textiles,3758,2119,1639,19,558
All,2015 Q2,C,Manufacturing,Manufacture of wearing apparel,6075,2763,3312,43,815
All,2015 Q2,C,Manufacturing,"Manufacture of leather and related products; Manufacture of wood and of products of wood and cork, articles of straw and plaiting materials (except furniture and toys)",498,329,169,13,136
All,2015 Q2,C,Manufacturing,Manufacture of paper and paper products,876,554,322,15,270
All,2015 Q2,C,Manufacturing,Printing and reproduction of recorded media,15574,10096,5478,173,2502
All,2015 Q2,C,Manufacturing,Manufacture of coke and refined petroleum products; Manufacture of chemicals and chemical products,1948,1397,551,84,199
All,2015 Q2,C,Manufacturing,"Manufacture of pharmaceuticals, medicinal chemical and botanical products",4559,1905,2654,91,245
All,2015 Q2,C,Manufacturing,"Manufacture of rubber and plastics products (except furniture, toys, sports goods and stationery)",2325,1562,763,35,333
All,2015 Q2,C,Manufacturing,Manufacture of other non-metallic mineral products,1258,1077,181,25,198
All,2015 Q2,C,Manufacturing,Manufacture of basic metals,1081,946,135,15,73
All,2015 Q2,C,Manufacturing,Manufacture of fabricated metal products (except machinery and equipment),2977,2219,758,4,747
All,2015 Q2,C,Manufacturing,"Manufacture of computer, electronic and optical products",3895,1966,1929,64,288
All,2015 Q2,C,Manufacturing,Manufacture of electrical equipment,1633,1085,548,67,198
All,2015 Q2,C,Manufacturing,Manufacture of machinery and equipment n.e.c.,1812,1453,359,42,338
All,2015 Q2,C,Manufacturing,Body assembly of motor vehicles; Manufacture of other transport equipment,470,396,74,16,74
All,2015 Q2,C,Manufacturing,Manufacture of furniture,474,364,110,10,152
All,2015 Q2,C,Manufacturing,Other manufacturing,7441,4779,2662,134,1327
All,2015 Q2,C,Manufacturing,Repair and installation of machinery and equipment,14051,11910,2141,922,1274
All,2015 Q2,B,Mining and quarrying,Quarrying and other mining of non-metal ores,76,66,10,0,2
All,2015 Q2,D,Electricity and gas supply,Electricity and gas supply,7796,6404,1392,87,8
All,2015 Q2,E,"Sewerage, waste management and remediation services",Sewerage,198,157,41,24,30
All,2015 Q2,E,"Sewerage, waste management and remediation services","Waste collection, treatment and disposal; materials recovery",2795,1836,959,205,363
All,2015 Q2,E,"Sewerage, waste management and remediation services",Remediation and other waste management services,6,5,1,0,4
All,2015 Q2,F,Construction,Construction sites (manual workers only),92808,83661,9147,935,1310
All,2015 Q2,F,Construction,Public sector sites,41922,39431,2491,508,549
All,2015 Q2,F,Construction,Public sector building sites,15275,13836,1439,94,169
All,2015 Q2,F,Construction,Public sector civil engineering sites,26647,25595,1052,414,380
All,2015 Q2,F,Construction,Private sector sites,50886,44230,6656,427,761
All,2015 Q2,F,Construction,Private sector building sites,48769,42239,6530,422,673
All,2015 Q2,F,Construction,Private sector civil engineering sites,2117,1991,126,5,88
All,2015 Q2,G,"Import/export, wholesale and retail trades",Import and export trade,484416,249452,234964,7045,102413
All,2015 Q2,G,"Import/export, wholesale and retail trades",Wholesale,61303,37600,23703,1153,13725
All,2015 Q2,G,"Import/export, wholesale and retail trades",Retail trade,269868,106084,163784,8439,65446
All,2015 Q2,H,"Transportation, storage, postal and courier services",Land transport,45346,38323,7023,970,1931
All,2015 Q2,H,"Transportation, storage, postal and courier services",Water transport,11368,6948,4420,202,394
All,2015 Q2,H,"Transportation, storage, postal and courier services",Air transport,27067,10288,16779,320,154
All,2015 Q2,H,"Transportation, storage, postal and courier services",Warehousing and support services for transportation,79427,50162,29265,1831,6625
All,2015 Q2,H,"Transportation, storage, postal and courier services",Postal and courier services,13300,9606,3694,739,672
All,2015 Q2,I,Accommodation and food services,Accommodation services,39625,20867,18758,1743,1223
All,2015 Q2,I,Accommodation and food services,Food and beverage services,243124,111009,132115,13407,16597
All,2015 Q2,J,Information and communications,Publishing,20888,11156,9732,256,1610
All,2015 Q2,J,Information and communications,"Motion picture, video and television programme production, sound recording and music publishing; Programming and broadcasting",16413,10256,6157,199,2374
All,2015 Q2,J,Information and communications,Telecommunications,18798,11606,7192,575,302
All,2015 Q2,J,Information and communications,Information technology services,42766,33083,9683,1229,7611
All,2015 Q2,J,Information and communications,Information services,6076,3738,2338,222,864
All,2015 Q2,K,Financing and insurance,Financial services (except insurance and pension funding),136805,66073,70732,3215,7454
All,2015 Q2,K,Financing and insurance,Insurance,15095,6021,9074,325,161
All,2015 Q2,K,Financing and insurance,Services auxiliary to financial and insurance services,67778,34767,33011,1768,15469
All,2015 Q2,L,Real estate,Real estate,129461,79644,49817,4274,15543
All,2015 Q2,M,"Professional, scientific and technical services",Legal and accounting services,51926,23929,27997,852,7746
All,2015 Q2,M,"Professional, scientific and technical services",Activities of head offices; management and management consultancy services,34811,17275,17536,920,7992
All,2015 Q2,M,"Professional, scientific and technical services","Architecture and engineering services, technical testing and analysis",40295,27295,13000,857,3305
All,2015 Q2,M,"Professional, scientific and technical services",Scientific research and development,2120,1515,605,110,154
All,2015 Q2,M,"Professional, scientific and technical services",Advertising and market research,14471,7649,6822,227,3688
All,2015 Q2,M,"Professional, scientific and technical services","Veterinary services; Other professional, scientific and technical services",23577,14536,9041,562,9058
All,2015 Q2,N,Administrative and support services,Rental and leasing services,3231,2023,1208,83,666
All,2015 Q2,N,Administrative and support services,Employment services,18040,7888,10152,554,2778
All,2015 Q2,N,Administrative and support services,"Travel agency, reservation service and related services",20817,7711,13106,597,2872
All,2015 Q2,N,Administrative and support services,Security and investigation services,48352,32528,15824,2128,238
All,2015 Q2,N,Administrative and support services,Services to buildings and landscape care,84223,26828,57395,1969,1754
All,2015 Q2,N,Administrative and support services,"Office administrative, office support and other business support services",21268,10490,10778,341,5289
All,2015 Q2,P,Education,Education,190701,70500,120201,3892,14163
All,2015 Q2,Q,Human health and social work services,Human health services,115216,32092,83124,4098,8002
All,2015 Q2,Q,Human health and social work services,Residential care services,29551,4595,24956,2292,1136
All,2015 Q2,Q,Human health and social work services,Social work services,31032,7167,23865,922,2042
All,2015 Q2,R,"Arts, entertainment and recreation",Creative and performing arts activities,4490,2385,2105,91,1923
All,2015 Q2,R,"Arts, entertainment and recreation","Libraries, archives, museums and other cultural activities",608,205,403,27,80
All,2015 Q2,R,"Arts, entertainment and recreation",Amusement parks and theme parks,6816,3637,3179,300,8
All,2015 Q2,R,"Arts, entertainment and recreation",Sports and other entertainment services,39497,20223,19274,1482,1365
All,2015 Q2,S,Other services,Activities of membership organisations,10522,4482,6040,337,1272
All,2015 Q2,S,Other services,"Repair of motor vehicles, motorcycles, computers, personal and household goods",19084,15545,3539,870,6662
All,2015 Q2,S,Other services,Other personal services,47678,13982,33696,2974,11931
All,2015 Q3,C,Manufacturing,Manufacture of food products,25617,12149,13468,1014,1112
All,2015 Q3,C,Manufacturing,Manufacture of beverages,3115,2353,762,62,30
All,2015 Q3,C,Manufacturing,Manufacture of tobacco products,559,356,203,80,3
All,2015 Q3,C,Manufacturing,Manufacture of textiles,3717,1925,1792,6,555
All,2015 Q3,C,Manufacturing,Manufacture of wearing apparel,5962,2247,3715,78,805
All,2015 Q3,C,Manufacturing,"Manufacture of leather and related products; Manufacture of wood and of products of wood and cork, articles of straw and plaiting materials (except furniture and toys)",483,325,158,16,133
All,2015 Q3,C,Manufacturing,Manufacture of paper and paper products,872,616,256,2,267
All,2015 Q3,C,Manufacturing,Printing and reproduction of recorded media,15574,10305,5269,260,2515
All,2015 Q3,C,Manufacturing,Manufacture of coke and refined petroleum products; Manufacture of chemicals and chemical products,1920,1392,528,91,194
All,2015 Q3,C,Manufacturing,"Manufacture of pharmaceuticals, medicinal chemical and botanical products",4543,1869,2674,120,244
All,2015 Q3,C,Manufacturing,"Manufacture of rubber and plastics products (except furniture, toys, sports goods and stationery)",2304,1475,829,29,330
All,2015 Q3,C,Manufacturing,Manufacture of other non-metallic mineral products,1294,1088,206,26,200
All,2015 Q3,C,Manufacturing,Manufacture of basic metals,1053,878,175,5,70
All,2015 Q3,C,Manufacturing,Manufacture of fabricated metal products (except machinery and equipment),2919,2206,713,25,736
All,2015 Q3,C,Manufacturing,"Manufacture of computer, electronic and optical products",3871,2153,1718,80,285
All,2015 Q3,C,Manufacturing,Manufacture of electrical equipment,1728,1124,604,32,195
All,2015 Q3,C,Manufacturing,Manufacture of machinery and equipment n.e.c.,1743,1532,211,35,322
All,2015 Q3,C,Manufacturing,Body assembly of motor vehicles; Manufacture of other transport equipment,463,379,84,19,73
All,2015 Q3,C,Manufacturing,Manufacture of furniture,468,364,104,4,151
All,2015 Q3,C,Manufacturing,Other manufacturing,7435,4990,2445,48,1312
All,2015 Q3,C,Manufacturing,Repair and installation of machinery and equipment,13961,11853,2108,663,1269
All,2015 Q3,B,Mining and quarrying,Quarrying and other mining of non-metal ores,75,66,9,0,2
All,2015 Q3,D,Electricity and gas supply,Electricity and gas supply,7893,6491,1402,99,7
All,2015 Q3,E,"Sewerage, waste management and remediation services",Sewerage,184,136,48,32,29
All,2015 Q3,E,"Sewerage, waste management and remediation services","Waste collection, treatment and disposal; materials recovery",2880,2047,833,155,360
All,2015 Q3,E,"Sewerage, waste management and remediation services",Remediation and other waste management services,4,2,2,0,4
All,2015 Q3,F,Construction,Construction sites (manual workers only),93745,84537,9208,710,1368
All,2015 Q3,F,Construction,Public sector sites,41984,38992,2992,338,571
All,2015 Q3,F,Construction,Public sector building sites,15110,13637,1473,58,176
All,2015 Q3,F,Construction,Public sector civil engineering sites,26874,25355,1519,280,395
All,2015 Q3,F,Construction,Private sector sites,51761,45545,6216,372,797
All,2015 Q3,F,Construction,Private sector building sites,50256,44152,6104,372,710
All,2015 Q3,F,Construction,Private sector civil engineering sites,1505,1393,112,0,87
All,2015 Q3,G,"Import/export, wholesale and retail trades",Import and export trade,483950,250734,233216,6483,102059
All,2015 Q3,G,"Import/export, wholesale and retail trades",Wholesale,61465,38419,23046,1122,13778
All,2015 Q3,G,"Import/export, wholesale and retail trades",Retail trade,268890,106735,162155,8352,65550
All,2015 Q3,H,"Transportation, storage, postal and courier services",Land transport,45676,38633,7043,680,1928
All,2015 Q3,H,"Transportation, storage, postal and courier services",Water transport,11511,7187,4324,165,388
All,2015 Q3,H,"Transportation, storage, postal and courier services",Air transport,27479,10421,17058,241,155
All,2015 Q3,H,"Transportation, storage, postal and courier services",Warehousing and support services for transportation,79617,48910,30707,1856,6513
All,2015 Q3,H,"Transportation, storage, postal and courier services",Postal and courier services,13889,9973,3916,499,697
All,2015 Q3,I,Accommodation and food services,Accommodation services,39514,20793,18721,1708,1227
All,2015 Q3,I,Accommodation and food services,Food and beverage services,242790,111555,131235,12891,16578
All,2015 Q3,J,Information and communications,Publishing,20639,11278,9361,281,1599
All,2015 Q3,J,Information and communications,"Motion picture, video and television programme production, sound recording and music publishing; Programming and broadcasting",16709,10400,6309,325,2358
All,2015 Q3,J,Information and communications,Telecommunications,19041,11700,7341,574,296
All,2015 Q3,J,Information and communications,Information technology services,43054,33682,9372,1266,7606
All,2015 Q3,J,Information and communications,Information services,6055,3448,2607,178,877
All,2015 Q3,K,Financing and insurance,Financial services (except insurance and pension funding),136560,66379,70181,2910,7457
All,2015 Q3,K,Financing and insurance,Insurance,15130,5876,9254,326,162
All,2015 Q3,K,Financing and insurance,Services auxiliary to financial and insurance services,68091,34694,33397,1691,15459
All,2015 Q3,L,Real estate,Real estate,129688,78124,51564,4618,15522
All,2015 Q3,M,"Professional, scientific and technical services",Legal and accounting services,52337,22812,29525,912,7774
All,2015 Q3,M,"Professional, scientific and technical services",Activities of head offices; management and management consultancy services,34878,17535,17343,802,8030
All,2015 Q3,M,"Professional, scientific and technical services","Architecture and engineering services, technical testing and analysis",40411,27364,13047,902,3307
All,2015 Q3,M,"Professional, scientific and technical services",Scientific research and development,2197,1589,608,86,161
All,2015 Q3,M,"Professional, scientific and technical services",Advertising and market research,14424,7687,6737,250,3661
All,2015 Q3,M,"Professional, scientific and technical services","Veterinary services; Other professional, scientific and technical services",23598,13312,10286,405,9057
All,2015 Q3,N,Administrative and support services,Rental and leasing services,3236,2083,1153,74,667
All,2015 Q3,N,Administrative and support services,Employment services,17700,7446,10254,466,2774
All,2015 Q3,N,Administrative and support services,"Travel agency, reservation service and related services",20730,7890,12840,512,2876
All,2015 Q3,N,Administrative and support services,Security and investigation services,48066,31913,16153,2310,241
All,2015 Q3,N,Administrative and support services,Services to buildings and landscape care,84310,27906,56404,2042,1761
All,2015 Q3,N,Administrative and support services,"Office administrative, office support and other business support services",21181,9647,11534,284,5283
All,2015 Q3,P,Education,Education,192504,69714,122790,3852,14581
All,2015 Q3,Q,Human health and social work services,Human health services,116755,32163,84592,2946,8166
All,2015 Q3,Q,Human health and social work services,Residential care services,29751,4234,25517,2320,1136
All,2015 Q3,Q,Human health and social work services,Social work services,30749,8336,22413,680,2028
All,2015 Q3,R,"Arts, entertainment and recreation",Creative and performing arts activities,4619,2419,2200,65,1967
All,2015 Q3,R,"Arts, entertainment and recreation","Libraries, archives, museums and other cultural activities",604,229,375,11,77
All,2015 Q3,R,"Arts, entertainment and recreation",Amusement parks and theme parks,6392,3518,2874,281,8
All,2015 Q3,R,"Arts, entertainment and recreation",Sports and other entertainment services,39055,20448,18607,1591,1353
All,2015 Q3,S,Other services,Activities of membership organisations,10427,4428,5999,333,1298
All,2015 Q3,S,Other services,"Repair of motor vehicles, motorcycles, computers, personal and household goods",19104,15904,3200,850,6618
All,2015 Q3,S,Other services,Other personal services,47437,13825,33612,2835,11931
All,2015 Q4,C,Manufacturing,Manufacture of food products,25627,12215,13412,1021,1112
All,2015 Q4,C,Manufacturing,Manufacture of beverages,3190,2458,732,60,30
All,2015 Q4,C,Manufacturing,Manufacture of tobacco products,622,382,240,73,3
All,2015 Q4,C,Manufacturing,Manufacture of textiles,3386,1904,1482,14,544
All,2015 Q4,C,Manufacturing,Manufacture of wearing apparel,5773,2771,3002,37,796
All,2015 Q4,C,Manufacturing,"Manufacture of leather and related products; Manufacture of wood and of products of wood and cork, articles of straw and plaiting materials (except furniture and toys)",472,324,148,6,133
All,2015 Q4,C,Manufacturing,Manufacture of paper and paper products,848,571,277,9,260
All,2015 Q4,C,Manufacturing,Printing and reproduction of recorded media,15330,10203,5127,149,2498
All,2015 Q4,C,Manufacturing,Manufacture of coke and refined petroleum products; Manufacture of chemicals and chemical products,1863,1071,792,32,194
All,2015 Q4,C,Manufacturing,"Manufacture of pharmaceuticals, medicinal chemical and botanical products",4525,1959,2566,108,240
All,2015 Q4,C,Manufacturing,"Manufacture of rubber and plastics products (except furniture, toys, sports goods and stationery)",2296,1330,966,45,327
All,2015 Q4,C,Manufacturing,Manufacture of other non-metallic mineral products,1318,1058,260,18,202
All,2015 Q4,C,Manufacturing,Manufacture of basic metals,1042,817,225,21,68
All,2015 Q4,C,Manufacturing,Manufacture of fabricated metal products (except machinery and equipment),2885,2041,844,35,730
All,2015 Q4,C,Manufacturing,"Manufacture of computer, electronic and optical products",3742,2088,1654,71,279
All,2015 Q4,C,Manufacturing,Manufacture of electrical equipment,1702,1022,680,22,191
All,2015 Q4,C,Manufacturing,Manufacture of machinery and equipment n.e.c.,1680,1335,345,63,313
All,2015 Q4,C,Manufacturing,Body assembly of motor vehicles; Manufacture of other transport equipment,424,343,81,14,73
All,2015 Q4,C,Manufacturing,Manufacture of furniture,466,328,138,14,150
All,2015 Q4,C,Manufacturing,Other manufacturing,7398,4791,2607,28,1293
All,2015 Q4,C,Manufacturing,Repair and installation of machinery and equipment,14290,12183,2107,633,1269
All,2015 Q4,B,Mining and quarrying,Quarrying and other mining of non-metal ores,72,64,8,0,2
All,2015 Q4,D,Electricity and gas supply,Electricity and gas supply,7883,6469,1414,76,6
All,2015 Q4,E,"Sewerage, waste management and remediation services",Sewerage,191,144,47,18,28
All,2015 Q4,E,"Sewerage, waste management and remediation services","Waste collection, treatment and disposal; materials recovery",2886,2059,827,174,360
All,2015 Q4,E,"Sewerage, waste management and remediation services",Remediation and other waste management services,4,2,2,0,4
All,2015 Q4,F,Construction,Construction sites (manual workers only),101982,91814,10168,654,1391
All,2015 Q4,F,Construction,Public sector sites,45394,42475,2919,452,577
All,2015 Q4,F,Construction,Public sector building sites,15833,14474,1359,9,202
All,2015 Q4,F,Construction,Public sector civil engineering sites,29561,28001,1560,443,375
All,2015 Q4,F,Construction,Private sector sites,56588,49339,7249,202,814
All,2015 Q4,F,Construction,Private sector building sites,55191,48012,7179,198,720
All,2015 Q4,F,Construction,Private sector civil engineering sites,1397,1327,70,4,94
All,2015 Q4,G,"Import/export, wholesale and retail trades",Import and export trade,484071,250470,233601,5635,101698
All,2015 Q4,G,"Import/export, wholesale and retail trades",Wholesale,61393,35462,25931,814,13666
All,2015 Q4,G,"Import/export, wholesale and retail trades",Retail trade,268072,106755,161317,7949,65142
All,2015 Q4,H,"Transportation, storage, postal and courier services",Land transport,45641,39107,6534,618,1885
All,2015 Q4,H,"Transportation, storage, postal and courier services",Water transport,11232,7037,4195,249,403
All,2015 Q4,H,"Transportation, storage, postal and courier services",Air transport,27860,10686,17174,385,160
All,2015 Q4,H,"Transportation, storage, postal and courier services",Warehousing and support services for transportation,79838,49342,30496,1371,6479
All,2015 Q4,H,"Transportation, storage, postal and courier services",Postal and courier services,13926,10286,3640,480,714
All,2015 Q4,I,Accommodation and food services,Accommodation services,40012,21287,18725,1418,1221
All,2015 Q4,I,Accommodation and food services,Food and beverage services,243257,111098,132159,11784,16639
All,2015 Q4,J,Information and communications,Publishing,20466,11383,9083,323,1573
All,2015 Q4,J,Information and communications,"Motion picture, video and television programme production, sound recording and music publishing; Programming and broadcasting",16922,10211,6711,509,2355
All,2015 Q4,J,Information and communications,Telecommunications,19596,12580,7016,692,300
All,2015 Q4,J,Information and communications,Information technology services,43355,32564,10791,1493,7607
All,2015 Q4,J,Information and communications,Information services,6188,3856,2332,145,897
All,2015 Q4,K,Financing and insurance,Financial services (except insurance and pension funding),136798,66299,70499,3773,7492
All,2015 Q4,K,Financing and insurance,Insurance,15178,5919,9259,430,164
All,2015 Q4,K,Financing and insurance,Services auxiliary to financial and insurance services,68460,34667,33793,1931,15605
All,2015 Q4,L,Real estate,Real estate,128650,78200,50450,4011,15645
All,2015 Q4,M,"Professional, scientific and technical services",Legal and accounting services,52662,24484,28178,742,7833
All,2015 Q4,M,"Professional, scientific and technical services",Activities of head offices; management and management consultancy services,35308,17591,17717,912,8103
All,2015 Q4,M,"Professional, scientific and technical services","Architecture and engineering services, technical testing and analysis",40520,26841,13679,865,3292
All,2015 Q4,M,"Professional, scientific and technical services",Scientific research and development,2272,1644,628,108,171
All,2015 Q4,M,"Professional, scientific and technical services",Advertising and market research,14272,7574,6698,293,3632
All,2015 Q4,M,"Professional, scientific and technical services","Veterinary services; Other professional, scientific and technical services",23642,13460,10182,388,9072
All,2015 Q4,N,Administrative and support services,Rental and leasing services,3230,2053,1177,75,673
All,2015 Q4,N,Administrative and support services,Employment services,17751,7520,10231,553,2789
All,2015 Q4,N,Administrative and support services,"Travel agency, reservation service and related services",20694,6961,13733,584,2874
All,2015 Q4,N,Administrative and support services,Security and investigation services,48278,31617,16661,2394,242
All,2015 Q4,N,Administrative and support services,Services to buildings and landscape care,83679,27315,56364,2009,1744
All,2015 Q4,N,Administrative and support services,"Office administrative, office support and other business support services",20977,9657,11320,370,5230
All,2015 Q4,P,Education,Education,193898,71714,122184,3742,14700
All,2015 Q4,Q,Human health and social work services,Human health services,118101,32070,86031,1862,8204
All,2015 Q4,Q,Human health and social work services,Residential care services,30456,4490,25966,2616,1162
All,2015 Q4,Q,Human health and social work services,Social work services,31543,7197,24346,746,2022
All,2015 Q4,R,"Arts, entertainment and recreation",Creative and performing arts activities,4649,2523,2126,104,1971
All,2015 Q4,R,"Arts, entertainment and recreation","Libraries, archives, museums and other cultural activities",604,209,395,23,85
All,2015 Q4,R,"Arts, entertainment and recreation",Amusement parks and theme parks,6190,3333,2857,263,10
All,2015 Q4,R,"Arts, entertainment and recreation",Sports and other entertainment services,39526,20261,19265,1561,1381
All,2015 Q4,S,Other services,Activities of membership organisations,10562,4527,6035,252,1276
All,2015 Q4,S,Other services,"Repair of motor vehicles, motorcycles, computers, personal and household goods",19012,15532,3480,741,6554
All,2015 Q4,S,Other services,Other personal services,47378,13767,33611,2633,11875
All,2016 Q1,C,Manufacturing,Manufacture of food products,25568,12744,12824,1155,1110
All,2016 Q1,C,Manufacturing,Manufacture of beverages,3185,2418,767,91,30
All,2016 Q1,C,Manufacturing,Manufacture of tobacco products,559,361,198,73,3
All,2016 Q1,C,Manufacturing,Manufacture of textiles,3138,1635,1503,20,533
All,2016 Q1,C,Manufacturing,Manufacture of wearing apparel,5774,2203,3571,42,777
All,2016 Q1,C,Manufacturing,"Manufacture of leather and related products; Manufacture of wood and of products of wood and cork, articles of straw and plaiting materials (except furniture and toys)",456,294,162,6,131
All,2016 Q1,C,Manufacturing,Manufacture of paper and paper products,850,597,253,11,255
All,2016 Q1,C,Manufacturing,Printing and reproduction of recorded media,15214,10192,5022,219,2476
All,2016 Q1,C,Manufacturing,Manufacture of coke and refined petroleum products; Manufacture of chemicals and chemical products,1801,1267,534,50,190
All,2016 Q1,C,Manufacturing,"Manufacture of pharmaceuticals, medicinal chemical and botanical products",4726,1881,2845,90,239
All,2016 Q1,C,Manufacturing,"Manufacture of rubber and plastics products (except furniture, toys, sports goods and stationery)",2246,1381,865,59,308
All,2016 Q1,C,Manufacturing,Manufacture of other non-metallic mineral products,1329,1089,240,23,203
All,2016 Q1,C,Manufacturing,Manufacture of basic metals,1021,842,179,15,65
All,2016 Q1,C,Manufacturing,Manufacture of fabricated metal products (except machinery and equipment),2814,2097,717,52,720
All,2016 Q1,C,Manufacturing,"Manufacture of computer, electronic and optical products",3557,1812,1745,67,272
All,2016 Q1,C,Manufacturing,Manufacture of electrical equipment,1619,1117,502,33,187
All,2016 Q1,C,Manufacturing,Manufacture of machinery and equipment n.e.c.,1618,1205,413,16,304
All,2016 Q1,C,Manufacturing,Body assembly of motor vehicles; Manufacture of other transport equipment,400,325,75,7,73
All,2016 Q1,C,Manufacturing,Manufacture of furniture,456,321,135,5,149
All,2016 Q1,C,Manufacturing,Other manufacturing,7264,4406,2858,37,1278
All,2016 Q1,C,Manufacturing,Repair and installation of machinery and equipment,14232,11961,2271,813,1262
All,2016 Q1,B,Mining and quarrying,Quarrying and other mining of non-metal ores,62,55,7,0,2
All,2016 Q1,D,Electricity and gas supply,Electricity and gas supply,7906,6452,1454,81,6
All,2016 Q1,E,"Sewerage, waste management and remediation services",Sewerage,160,113,47,9,26
All,2016 Q1,E,"Sewerage, waste management and remediation services","Waste collection, treatment and disposal; materials recovery",2727,1781,946,197,377
All,2016 Q1,E,"Sewerage, waste management and remediation services",Remediation and other waste management services,4,2,2,0,4
All,2016 Q1,F,Construction,Construction sites (manual workers only),104813,94002,10811,960,1441
All,2016 Q1,F,Construction,Public sector sites,46074,42811,3263,483,599
All,2016 Q1,F,Construction,Public sector building sites,15949,14509,1440,6,208
All,2016 Q1,F,Construction,Public sector civil engineering sites,30125,28302,1823,477,391
All,2016 Q1,F,Construction,Private sector sites,58739,51191,7548,477,842
All,2016 Q1,F,Construction,Private sector building sites,57069,49620,7449,474,744
All,2016 Q1,F,Construction,Private sector civil engineering sites,1670,1571,99,3,98
All,2016 Q1,G,"Import/export, wholesale and retail trades",Import and export trade,481653,250367,231286,5707,101153
All,2016 Q1,G,"Import/export, wholesale and retail trades",Wholesale,61275,37418,23857,1216,13657
All,2016 Q1,G,"Import/export, wholesale and retail trades",Retail trade,266245,104706,161539,7655,64498
All,2016 Q1,H,"Transportation, storage, postal and courier services",Land transport,45345,38710,6635,908,1804
All,2016 Q1,H,"Transportation, storage, postal and courier services",Water transport,11602,7231,4371,125,426
All,2016 Q1,H,"Transportation, storage, postal and courier services",Air transport,28443,10963,17480,478,163
All,2016 Q1,H,"Transportation, storage, postal and courier services",Warehousing and support services for transportation,79346,48761,30585,1594,6493
All,2016 Q1,H,"Transportation, storage, postal and courier services",Postal and courier services,13889,9100,4789,330,698
All,2016 Q1,I,Accommodation and food services,Accommodation services,38789,20496,18293,1790,1221
All,2016 Q1,I,Accommodation and food services,Food and beverage services,241827,109764,132063,11140,16516
All,2016 Q1,J,Information and communications,Publishing,19933,10713,9220,290,1549
All,2016 Q1,J,Information and communications,"Motion picture, video and television programme production, sound recording and music publishing; Programming and broadcasting",16909,10122,6787,201,2372
All,2016 Q1,J,Information and communications,Telecommunications,19670,12195,7475,623,299
All,2016 Q1,J,Information and communications,Information technology services,43040,33002,10038,1296,7539
All,2016 Q1,J,Information and communications,Information services,6142,3662,2480,141,884
All,2016 Q1,K,Financing and insurance,Financial services (except insurance and pension funding),137024,67049,69975,2934,7500
All,2016 Q1,K,Financing and insurance,Insurance,15439,5987,9452,517,164
All,2016 Q1,K,Financing and insurance,Services auxiliary to financial and insurance services,68766,34503,34263,1727,15810
All,2016 Q1,L,Real estate,Real estate,128463,77991,50472,4232,15708
All,2016 Q1,M,"Professional, scientific and technical services",Legal and accounting services,52878,23822,29056,847,7881
All,2016 Q1,M,"Professional, scientific and technical services",Activities of head offices; management and management consultancy services,35559,17026,18533,766,8170
All,2016 Q1,M,"Professional, scientific and technical services","Architecture and engineering services, technical testing and analysis",40409,26914,13495,734,3290
All,2016 Q1,M,"Professional, scientific and technical services",Scientific research and development,2282,1647,635,95,173
All,2016 Q1,M,"Professional, scientific and technical services",Advertising and market research,14169,7681,6488,240,3599
All,2016 Q1,M,"Professional, scientific and technical services","Veterinary services; Other professional, scientific and technical services",23584,13665,9919,394,9049
All,2016 Q1,N,Administrative and support services,Rental and leasing services,3233,2185,1048,73,673
All,2016 Q1,N,Administrative and support services,Employment services,17840,8203,9637,536,2772
All,2016 Q1,N,Administrative and support services,"Travel agency, reservation service and related services",20786,8025,12761,573,2883
All,2016 Q1,N,Administrative and support services,Security and investigation services,48569,31885,16684,2417,235
All,2016 Q1,N,Administrative and support services,Services to buildings and landscape care,84184,28053,56131,1957,1733
All,2016 Q1,N,Administrative and support services,"Office administrative, office support and other business support services",20899,9232,11667,354,5199
All,2016 Q1,P,Education,Education,196033,71041,124992,4013,14896
All,2016 Q1,Q,Human health and social work services,Human health services,119630,32338,87292,1682,8277
All,2016 Q1,Q,Human health and social work services,Residential care services,31223,4938,26285,2424,1162
All,2016 Q1,Q,Human health and social work services,Social work services,31673,7817,23856,774,2027
All,2016 Q1,R,"Arts, entertainment and recreation",Creative and performing arts activities,4786,2571,2215,150,1984
All,2016 Q1,R,"Arts, entertainment and recreation","Libraries, archives, museums and other cultural activities",570,202,368,15,83
All,2016 Q1,R,"Arts, entertainment and recreation",Amusement parks and theme parks,5713,3099,2614,431,9
All,2016 Q1,R,"Arts, entertainment and recreation",Sports and other entertainment services,38929,19879,19050,1057,1391
All,2016 Q1,S,Other services,Activities of membership organisations,10715,4784,5931,392,1288
All,2016 Q1,S,Other services,"Repair of motor vehicles, motorcycles, computers, personal and household goods",18898,15591,3307,821,6580
All,2016 Q1,S,Other services,Other personal services,47294,13147,34147,2521,11881
All,2016 Q2,C,Manufacturing,Manufacture of food products,25501,12328,13173,697,1116
All,2016 Q2,C,Manufacturing,Manufacture of beverages,2934,2369,565,89,29
All,2016 Q2,C,Manufacturing,Manufacture of tobacco products,548,356,192,70,3
All,2016 Q2,C,Manufacturing,Manufacture of textiles,2918,1499,1419,21,503
All,2016 Q2,C,Manufacturing,Manufacture of wearing apparel,5423,2182,3241,43,748
All,2016 Q2,C,Manufacturing,"Manufacture of leather and related products; Manufacture of wood and of products of wood and cork, articles of straw and plaiting materials (except furniture and toys)",441,293,148,6,128
All,2016 Q2,C,Manufacturing,Manufacture of paper and paper products,850,540,310,2,256
All,2016 Q2,C,Manufacturing,Printing and reproduction of recorded media,15010,9829,5181,169,2465
All,2016 Q2,C,Manufacturing,Manufacture of coke and refined petroleum products; Manufacture of chemicals and chemical products,1783,981,802,35,189
All,2016 Q2,C,Manufacturing,"Manufacture of pharmaceuticals, medicinal chemical and botanical products",4670,1967,2703,153,237
All,2016 Q2,C,Manufacturing,"Manufacture of rubber and plastics products (except furniture, toys, sports goods and stationery)",2171,1433,738,31,295
All,2016 Q2,C,Manufacturing,Manufacture of other non-metallic mineral products,1309,1049,260,23,202
All,2016 Q2,C,Manufacturing,Manufacture of basic metals,1017,830,187,15,61
All,2016 Q2,C,Manufacturing,Manufacture of fabricated metal products (except machinery and equipment),2771,1879,892,65,709
All,2016 Q2,C,Manufacturing,"Manufacture of computer, electronic and optical products",3418,1789,1629,65,270
All,2016 Q2,C,Manufacturing,Manufacture of electrical equipment,1569,1107,462,32,183
All,2016 Q2,C,Manufacturing,Manufacture of machinery and equipment n.e.c.,1604,1165,439,43,299
All,2016 Q2,C,Manufacturing,Body assembly of motor vehicles; Manufacture of other transport equipment,362,316,46,10,72
All,2016 Q2,C,Manufacturing,Manufacture of furniture,451,355,96,6,147
All,2016 Q2,C,Manufacturing,Other manufacturing,7163,4228,2935,52,1257
All,2016 Q2,C,Manufacturing,Repair and installation of machinery and equipment,14181,11875,2306,657,1256
All,2016 Q2,B,Mining and quarrying,Quarrying and other mining of non-metal ores,61,55,6,0,2
All,2016 Q2,D,Electricity and gas supply,Electricity and gas supply,7831,6401,1430,74,6
All,2016 Q2,E,"Sewerage, waste management and remediation services",Sewerage,169,122,47,14,27
All,2016 Q2,E,"Sewerage, waste management and remediation services","Waste collection, treatment and disposal; materials recovery",2899,1883,1016,168,367
All,2016 Q2,E,"Sewerage, waste management and remediation services",Remediation and other waste management services,3,2,1,0,3
All,2016 Q2,F,Construction,Construction sites (manual workers only),106193,95685,10508,546,1399
All,2016 Q2,F,Construction,Public sector sites,45319,41934,3385,387,571
All,2016 Q2,F,Construction,Public sector building sites,15047,13703,1344,8,197
All,2016 Q2,F,Construction,Public sector civil engineering sites,30272,28231,2041,379,374
All,2016 Q2,F,Construction,Private sector sites,60874,53751,7123,159,828
All,2016 Q2,F,Construction,Private sector building sites,59557,52514,7043,159,737
All,2016 Q2,F,Construction,Private sector civil engineering sites,1317,1237,80,0,91
All,2016 Q2,G,"Import/export, wholesale and retail trades",Import and export trade,481828,247315,234513,5823,101103
All,2016 Q2,G,"Import/export, wholesale and retail trades",Wholesale,61220,35571,25649,1115,13630
All,2016 Q2,G,"Import/export, wholesale and retail trades",Retail trade,266151,107035,159116,7097,63589
All,2016 Q2,H,"Transportation, storage, postal and courier services",Land transport,45434,38533,6901,616,1780
All,2016 Q2,H,"Transportation, storage, postal and courier services",Water transport,11465,7059,4406,141,428
All,2016 Q2,H,"Transportation, storage, postal and courier services",Air transport,28180,10958,17222,285,164
All,2016 Q2,H,"Transportation, storage, postal and courier services",Warehousing and support services for transportation,78965,48816,30149,1988,6572
All,2016 Q2,H,"Transportation, storage, postal and courier services",Postal and courier services,13820,10013,3807,255,712
All,2016 Q2,I,Accommodation and food services,Accommodation services,38651,20357,18294,1737,1230
All,2016 Q2,I,Accommodation and food services,Food and beverage services,242175,111393,130782,11300,16442
All,2016 Q2,J,Information and communications,Publishing,19640,10142,9498,283,1529
All,2016 Q2,J,Information and communications,"Motion picture, video and television programme production, sound recording and music publishing; Programming and broadcasting",16218,9794,6424,229,2380
All,2016 Q2,J,Information and communications,Telecommunications,19856,12315,7541,579,308
All,2016 Q2,J,Information and communications,Information technology services,43183,32480,10703,1243,7626
All,2016 Q2,J,Information and communications,Information services,6207,3639,2568,139,911
All,2016 Q2,K,Financing and insurance,Financial services (except insurance and pension funding),135850,65439,70411,3033,7570
All,2016 Q2,K,Financing and insurance,Insurance,15864,6164,9700,490,167
All,2016 Q2,K,Financing and insurance,Services auxiliary to financial and insurance services,68851,34739,34112,1708,16032
All,2016 Q2,L,Real estate,Real estate,128878,77576,51302,3998,15754
All,2016 Q2,M,"Professional, scientific and technical services",Legal and accounting services,53262,24859,28403,880,7956
All,2016 Q2,M,"Professional, scientific and technical services",Activities of head offices; management and management consultancy services,35784,17626,18158,847,8274
All,2016 Q2,M,"Professional, scientific and technical services","Architecture and engineering services, technical testing and analysis",40623,27310,13313,1023,3325
All,2016 Q2,M,"Professional, scientific and technical services",Scientific research and development,2329,1649,680,141,183
All,2016 Q2,M,"Professional, scientific and technical services",Advertising and market research,14206,7272,6934,199,3601
All,2016 Q2,M,"Professional, scientific and technical services","Veterinary services; Other professional, scientific and technical services",23789,13443,10346,431,9135
All,2016 Q2,N,Administrative and support services,Rental and leasing services,3234,1990,1244,73,670
All,2016 Q2,N,Administrative and support services,Employment services,18106,7991,10115,576,2789
All,2016 Q2,N,Administrative and support services,"Travel agency, reservation service and related services",20821,8558,12263,591,2886
All,2016 Q2,N,Administrative and support services,Security and investigation services,50169,32027,18142,2091,240
All,2016 Q2,N,Administrative and support services,Services to buildings and landscape care,85216,28588,56628,1646,1730
All,2016 Q2,N,Administrative and support services,"Office administrative, office support and other business support services",21017,10518,10499,291,5192
All,2016 Q2,P,Education,Education,194950,71214,123736,3991,14853
All,2016 Q2,Q,Human health and social work services,Human health services,120306,32923,87383,2003,8303
All,2016 Q2,Q,Human health and social work services,Residential care services,31359,4669,26690,2581,1146
All,2016 Q2,Q,Human health and social work services,Social work services,31452,8052,23400,805,2025
All,2016 Q2,R,"Arts, entertainment and recreation",Creative and performing arts activities,4757,2523,2234,120,1944
All,2016 Q2,R,"Arts, entertainment and recreation","Libraries, archives, museums and other cultural activities",595,219,376,32,83
All,2016 Q2,R,"Arts, entertainment and recreation",Amusement parks and theme parks,5814,3182,2632,432,11
All,2016 Q2,R,"Arts, entertainment and recreation",Sports and other entertainment services,37794,18948,18846,914,1394
All,2016 Q2,S,Other services,Activities of membership organisations,10803,5669,5134,341,1318
All,2016 Q2,S,Other services,"Repair of motor vehicles, motorcycles, computers, personal and household goods",18793,15475,3318,561,6593
All,2016 Q2,S,Other services,Other personal services,46773,13550,33223,2484,11843
All,2016 Q3,C,Manufacturing,Manufacture of food products,25505,12087,13418,867,1129
All,2016 Q3,C,Manufacturing,Manufacture of beverages,2974,2269,705,169,27
All,2016 Q3,C,Manufacturing,Manufacture of tobacco products,558,365,193,73,3
All,2016 Q3,C,Manufacturing,Manufacture of textiles,2770,1255,1515,6,488
All,2016 Q3,C,Manufacturing,Manufacture of wearing apparel,5278,2411,2867,57,725
All,2016 Q3,C,Manufacturing,"Manufacture of leather and related products; Manufacture of wood and of products of wood and cork, articles of straw and plaiting materials (except furniture and toys)",410,285,125,9,124
All,2016 Q3,C,Manufacturing,Manufacture of paper and paper products,857,604,253,7,246
All,2016 Q3,C,Manufacturing,Printing and reproduction of recorded media,14883,10230,4653,86,2451
All,2016 Q3,C,Manufacturing,Manufacture of coke and refined petroleum products; Manufacture of chemicals and chemical products,1766,1055,711,7,187
All,2016 Q3,C,Manufacturing,"Manufacture of pharmaceuticals, medicinal chemical and botanical products",4710,1741,2969,51,235
All,2016 Q3,C,Manufacturing,"Manufacture of rubber and plastics products (except furniture, toys, sports goods and stationery)",2150,1492,658,52,288
All,2016 Q3,C,Manufacturing,Manufacture of other non-metallic mineral products,1311,1055,256,22,200
All,2016 Q3,C,Manufacturing,Manufacture of basic metals,1018,792,226,19,62
All,2016 Q3,C,Manufacturing,Manufacture of fabricated metal products (except machinery and equipment),2724,1760,964,4,697
All,2016 Q3,C,Manufacturing,"Manufacture of computer, electronic and optical products",3262,1782,1480,65,251
All,2016 Q3,C,Manufacturing,Manufacture of electrical equipment,1579,1121,458,27,174
All,2016 Q3,C,Manufacturing,Manufacture of machinery and equipment n.e.c.,1590,1287,303,1,292
All,2016 Q3,C,Manufacturing,Body assembly of motor vehicles; Manufacture of other transport equipment,365,291,74,8,68
All,2016 Q3,C,Manufacturing,Manufacture of furniture,438,346,92,0,143
All,2016 Q3,C,Manufacturing,Other manufacturing,6920,4082,2838,34,1235
All,2016 Q3,C,Manufacturing,Repair and installation of machinery and equipment,14198,11892,2306,535,1243
All,2016 Q3,B,Mining and quarrying,Quarrying and other mining of non-metal ores,63,55,8,0,2
All,2016 Q3,D,Electricity and gas supply,Electricity and gas supply,7928,6454,1474,74,6
All,2016 Q3,E,"Sewerage, waste management and remediation services",Sewerage,180,139,41,12,28
All,2016 Q3,E,"Sewerage, waste management and remediation services","Waste collection, treatment and disposal; materials recovery",3009,2182,827,109,361
All,2016 Q3,E,"Sewerage, waste management and remediation services",Remediation and other waste management services,8,4,4,0,4
All,2016 Q3,F,Construction,Construction sites (manual workers only),107819,96997,10822,592,1403
All,2016 Q3,F,Construction,Public sector sites,45394,42207,3187,496,558
All,2016 Q3,F,Construction,Public sector building sites,15152,13818,1334,31,178
All,2016 Q3,F,Construction,Public sector civil engineering sites,30242,28389,1853,465,380
All,2016 Q3,F,Construction,Private sector sites,62425,54790,7635,96,845
All,2016 Q3,F,Construction,Private sector building sites,61091,53532,7559,96,757
All,2016 Q3,F,Construction,Private sector civil engineering sites,1334,1258,76,0,88
All,2016 Q3,G,"Import/export, wholesale and retail trades",Import and export trade,481282,248194,233088,5747,100674
All,2016 Q3,G,"Import/export, wholesale and retail trades",Wholesale,60679,36263,24416,1284,13587
All,2016 Q3,G,"Import/export, wholesale and retail trades",Retail trade,266521,106020,160501,8279,63808
All,2016 Q3,H,"Import/export, wholesale and retail trades",Land transport,45565,38916,6649,815,1759
All,2016 Q3,H,"Transportation, storage, postal and courier services",Water transport,11548,7110,4438,116,414
All,2016 Q3,H,"Transportation, storage, postal and courier services",Air transport,28130,10593,17537,235,166
All,2016 Q3,H,"Transportation, storage, postal and courier services",Warehousing and support services for transportation,79135,48385,30750,1772,6653
All,2016 Q3,H,"Transportation, storage, postal and courier services",Postal and courier services,13806,10267,3539,268,712
All,2016 Q3,I,Accommodation and food services,Accommodation services,39059,20463,18596,1541,1231
All,2016 Q3,I,Accommodation and food services,Food and beverage services,243020,108450,134570,11684,16587
All,2016 Q3,J,Information and communications,Publishing,19418,10603,8815,238,1522
All,2016 Q3,J,Information and communications,"Motion picture, video and television programme production, sound recording and music publishing; Programming and broadcasting",16376,9666,6710,488,2438
All,2016 Q3,J,Information and communications,Telecommunications,20263,12608,7655,669,320
All,2016 Q3,J,Information and communications,Information technology services,43241,32459,10782,1277,7743
All,2016 Q3,J,Information and communications,Information services,6373,3641,2732,158,958
All,2016 Q3,K,Financing and insurance,Financial services (except insurance and pension funding),135836,66312,69524,3266,7604
All,2016 Q3,K,Financing and insurance,Insurance,16102,6539,9563,475,174
All,2016 Q3,K,Financing and insurance,Services auxiliary to financial and insurance services,68872,34759,34113,1677,16093
All,2016 Q3,L,Real estate,Real estate,129682,78610,51072,4053,15874
All,2016 Q3,M,"Professional, scientific and technical services",Legal and accounting services,53604,23811,29793,861,8066
All,2016 Q3,M,"Professional, scientific and technical services",Activities of head offices; management and management consultancy services,36123,17842,18281,811,8358
All,2016 Q3,M,"Professional, scientific and technical services","Architecture and engineering services, technical testing and analysis",41043,27636,13407,830,3352
All,2016 Q3,M,"Professional, scientific and technical services",Scientific research and development,2423,1715,708,142,194
All,2016 Q3,M,"Professional, scientific and technical services",Advertising and market research,14156,7457,6699,154,3582
All,2016 Q3,M,"Professional, scientific and technical services","Veterinary services; Other professional, scientific and technical services",23905,13837,10068,425,9194
All,2016 Q3,N,Administrative and support services,Rental and leasing services,3276,2336,940,76,679
All,2016 Q3,N,Administrative and support services,Employment services,18005,7925,10080,457,2798
All,2016 Q3,N,Administrative and support services,"Travel agency, reservation service and related services",20708,8575,12133,546,2877
All,2016 Q3,N,Administrative and support services,Security and investigation services,51295,33026,18269,1816,234
All,2016 Q3,N,Administrative and support services,Services to buildings and landscape care,84594,27572,57022,1785,1757
All,2016 Q3,N,Administrative and support services,"Office administrative, office support and other business support services",20964,9899,11065,299,5183
All,2016 Q3,P,Education,Education,195971,71442,124529,3709,15022
All,2016 Q3,Q,Human health and social work services,Human health services,121805,32726,89079,2269,8323
All,2016 Q3,Q,Human health and social work services,Residential care services,31212,4358,26854,2489,1154
All,2016 Q3,Q,Human health and social work services,Social work services,31235,6929,24306,582,2029
All,2016 Q3,R,"Arts, entertainment and recreation",Creative and performing arts activities,4840,2444,2396,39,1948
All,2016 Q3,R,"Arts, entertainment and recreation","Libraries, archives, museums and other cultural activities",608,231,377,17,82
All,2016 Q3,R,"Arts, entertainment and recreation",Amusement parks and theme parks,6335,3487,2848,381,10
All,2016 Q3,R,"Arts, entertainment and recreation",Sports and other entertainment services,37045,18735,18310,1324,1406
All,2016 Q3,S,Other services,Activities of membership organisations,10742,5222,5520,332,1330
All,2016 Q3,S,Other services,"Repair of motor vehicles, motorcycles, computers, personal and household goods",18835,15662,3173,567,6610
All,2016 Q3,S,Other services,Other personal services,46592,13377,33215,2501,11871
All,2016 Q4,C,Manufacturing,Manufacture of food products,25469,12922,12547,853,1140
All,2016 Q4,C,Manufacturing,Manufacture of beverages,3103,2338,765,155,29
All,2016 Q4,C,Manufacturing,Manufacture of tobacco products,571,364,207,71,3
All,2016 Q4,C,Manufacturing,Manufacture of textiles,2665,1256,1409,8,458
All,2016 Q4,C,Manufacturing,Manufacture of wearing apparel,5065,2414,2651,33,688
All,2016 Q4,C,Manufacturing,"Manufacture of leather and related products; Manufacture of wood and of products of wood and cork, articles of straw and plaiting materials (except furniture and toys)",394,288,106,3,124
All,2016 Q4,C,Manufacturing,Manufacture of paper and paper products,853,640,213,9,239
All,2016 Q4,C,Manufacturing,Printing and reproduction of recorded media,14661,9620,5041,138,2400
All,2016 Q4,C,Manufacturing,Manufacture of coke and refined petroleum products; Manufacture of chemicals and chemical products,1680,1087,593,6,189
All,2016 Q4,C,Manufacturing,"Manufacture of pharmaceuticals, medicinal chemical and botanical products",4862,1898,2964,180,227
All,2016 Q4,C,Manufacturing,"Manufacture of rubber and plastics products (except furniture, toys, sports goods and stationery)",2132,1199,933,63,274
All,2016 Q4,C,Manufacturing,Manufacture of other non-metallic mineral products,1610,1311,299,25,196
All,2016 Q4,C,Manufacturing,Manufacture of basic metals,1028,833,195,29,62
All,2016 Q4,C,Manufacturing,Manufacture of fabricated metal products (except machinery and equipment),2632,1807,825,5,658
All,2016 Q4,C,Manufacturing,"Manufacture of computer, electronic and optical products",3122,1568,1554,37,245
All,2016 Q4,C,Manufacturing,Manufacture of electrical equipment,1590,1103,487,32,167
All,2016 Q4,C,Manufacturing,Manufacture of machinery and equipment n.e.c.,1484,1139,345,0,280
All,2016 Q4,C,Manufacturing,Body assembly of motor vehicles; Manufacture of other transport equipment,356,298,58,3,68
All,2016 Q4,C,Manufacturing,Manufacture of furniture,402,279,123,4,139
All,2016 Q4,C,Manufacturing,Other manufacturing,6773,4129,2644,78,1210
All,2016 Q4,C,Manufacturing,Repair and installation of machinery and equipment,14404,11974,2430,335,1236
All,2016 Q4,B,Mining and quarrying,Quarrying and other mining of non-metal ores,61,53,8,0,2
All,2016 Q4,D,Electricity and gas supply,Electricity and gas supply,7917,6447,1470,64,6
All,2016 Q4,E,"Sewerage, waste management and remediation services",Sewerage,192,147,45,3,28
All,2016 Q4,E,"Sewerage, waste management and remediation services","Waste collection, treatment and disposal; materials recovery",3074,2122,952,116,352
All,2016 Q4,E,"Sewerage, waste management and remediation services",Remediation and other waste management services,7,3,4,0,4
All,2016 Q4,F,Construction,Construction sites (manual workers only),112370,100695,11675,848,1391
All,2016 Q4,F,Construction,Public sector sites,47894,44663,3231,587,570
All,2016 Q4,F,Construction,Public sector building sites,17971,16517,1454,25,189
All,2016 Q4,F,Construction,Public sector civil engineering sites,29923,28146,1777,562,381
All,2016 Q4,F,Construction,Private sector sites,64476,56032,8444,261,821
All,2016 Q4,F,Construction,Private sector building sites,63255,54876,8379,261,748
All,2016 Q4,F,Construction,Private sector civil engineering sites,1221,1156,65,0,73
All,2016 Q4,G,"Import/export, wholesale and retail trades",Import and export trade,480963,248465,232498,5991,100587
All,2016 Q4,G,"Import/export, wholesale and retail trades",Wholesale,60647,36754,23893,1082,13579
All,2016 Q4,G,"Import/export, wholesale and retail trades",Retail trade,267534,107710,159824,7373,63726
All,2016 Q4,H,"Transportation, storage, postal and courier services",Land transport,45397,38259,7138,656,1737
All,2016 Q4,H,"Transportation, storage, postal and courier services",Water transport,11722,6825,4897,127,414
All,2016 Q4,H,"Transportation, storage, postal and courier services",Air transport,27888,10615,17273,330,166
All,2016 Q4,H,"Transportation, storage, postal and courier services",Warehousing and support services for transportation,79735,49515,30220,1651,6668
All,2016 Q4,H,"Transportation, storage, postal and courier services",Postal and courier services,14060,10077,3983,276,728
All,2016 Q4,I,Accommodation and food services,Accommodation services,39566,20423,19143,1553,1234
All,2016 Q4,I,Accommodation and food services,Food and beverage services,243313,110214,133099,11807,16662
All,2016 Q4,J,Information and communications,Publishing,19353,10351,9002,298,1523
All,2016 Q4,J,Information and communications,"Motion picture, video and television programme production, sound recording and music publishing; Programming and broadcasting",16978,10318,6660,462,2499
All,2016 Q4,J,Information and communications,Telecommunications,20642,12676,7966,446,316
All,2016 Q4,J,Information and communications,Information technology services,43907,33087,10820,1369,7837
All,2016 Q4,J,Information and communications,Information services,6462,3552,2910,133,980
All,2016 Q4,K,Financing and insurance,Financial services (except insurance and pension funding),136956,66416,70540,2801,7652
All,2016 Q4,K,Financing and insurance,Insurance,16373,6493,9880,533,174
All,2016 Q4,K,Financing and insurance,Services auxiliary to financial and insurance services,69391,34809,34582,1635,16553
All,2016 Q4,L,Real estate,Real estate,130033,79095,50938,3950,15991
All,2016 Q4,M,"Professional, scientific and technical services",Legal and accounting services,53985,24218,29767,799,8162
All,2016 Q4,M,"Professional, scientific and technical services",Activities of head offices; management and management consultancy services,36654,17472,19182,822,8462
All,2016 Q4,M,"Professional, scientific and technical services","Architecture and engineering services, technical testing and analysis",41495,28115,13380,748,3388
All,2016 Q4,M,"Professional, scientific and technical services",Scientific research and development,2533,1784,749,194,209
All,2016 Q4,M,"Professional, scientific and technical services",Advertising and market research,14169,7458,6711,155,3584
All,2016 Q4,M,"Professional, scientific and technical services","Veterinary services; Other professional, scientific and technical services",24161,13761,10400,430,9307
All,2016 Q4,N,Administrative and support services,Rental and leasing services,3314,2056,1258,74,688
All,2016 Q4,N,Administrative and support services,Employment services,18078,8229,9849,460,2805
All,2016 Q4,N,Administrative and support services,"Travel agency, reservation service and related services",20706,7711,12995,463,2873
All,2016 Q4,N,Administrative and support services,Security and investigation services,51696,33176,18520,1806,232
All,2016 Q4,N,Administrative and support services,Services to buildings and landscape care,84738,28418,56320,1890,1756
All,2016 Q4,N,Administrative and support services,"Office administrative, office support and other business support services",20892,9456,11436,314,5166
All,2016 Q4,P,Education,Education,198380,72552,125828,3470,15118
All,2016 Q4,Q,Human health and social work services,Human health services,123066,33144,89922,1625,8348
All,2016 Q4,Q,Human health and social work services,Residential care services,30973,4957,26016,2793,1154
All,2016 Q4,Q,Human health and social work services,Social work services,31550,8128,23422,647,2035
All,2016 Q4,R,"Arts, entertainment and recreation",Creative and performing arts activities,4851,2567,2284,82,1943
All,2016 Q4,R,"Arts, entertainment and recreation","Libraries, archives, museums and other cultural activities",604,214,390,6,81
All,2016 Q4,R,"Arts, entertainment and recreation",Amusement parks and theme parks,5751,3096,2655,379,10
All,2016 Q4,R,"Arts, entertainment and recreation",Sports and other entertainment services,36744,18565,18179,1525,1379
All,2016 Q4,S,Other services,Activities of membership organisations,10734,4875,5859,340,1338
All,2016 Q4,S,Other services,"Repair of motor vehicles, motorcycles, computers, personal and household goods",18716,15274,3442,383,6617
All,2016 Q4,S,Other services,Other personal services,46583,14357,32226,2164,11862
All,2017 Q1,C,Manufacturing,Manufacture of food products,25819,12549,13270,1129,1148
All,2017 Q1,C,Manufacturing,Manufacture of beverages,3100,2327,773,196,31
All,2017 Q1,C,Manufacturing,Manufacture of tobacco products,562,357,205,21,3
All,2017 Q1,C,Manufacturing,Manufacture of textiles,2569,1304,1265,22,446
All,2017 Q1,C,Manufacturing,Manufacture of wearing apparel,4763,2167,2596,12,657
All,2017 Q1,C,Manufacturing,"Manufacture of leather and related products; Manufacture of wood and of products of wood and cork, articles of straw and plaiting materials (except furniture and toys)",416,270,146,10,129
All,2017 Q1,C,Manufacturing,Manufacture of paper and paper products,827,582,245,1,236
All,2017 Q1,C,Manufacturing,Printing and reproduction of recorded media,14496,9250,5246,125,2337
All,2017 Q1,C,Manufacturing,Manufacture of coke and refined petroleum products; Manufacture of chemicals and chemical products,1687,1144,543,3,189
All,2017 Q1,C,Manufacturing,"Manufacture of pharmaceuticals, medicinal chemical and botanical products",5023,2061,2962,225,225
All,2017 Q1,C,Manufacturing,"Manufacture of rubber and plastics products (except furniture, toys, sports goods and stationery)",2086,1255,831,45,275
All,2017 Q1,C,Manufacturing,Manufacture of other non-metallic mineral products,1460,1139,321,45,194
All,2017 Q1,C,Manufacturing,Manufacture of basic metals,1010,749,261,35,62
All,2017 Q1,C,Manufacturing,Manufacture of fabricated metal products (except machinery and equipment),2523,1885,638,69,629
All,2017 Q1,C,Manufacturing,"Manufacture of computer, electronic and optical products",3004,1550,1454,45,238
All,2017 Q1,C,Manufacturing,Manufacture of electrical equipment,1570,1110,460,29,170
All,2017 Q1,C,Manufacturing,Manufacture of machinery and equipment n.e.c.,1444,1119,325,12,272
All,2017 Q1,C,Manufacturing,Body assembly of motor vehicles; Manufacture of other transport equipment,360,303,57,4,68
All,2017 Q1,C,Manufacturing,Manufacture of furniture,404,303,101,4,140
All,2017 Q1,C,Manufacturing,Other manufacturing,6522,3862,2660,43,1199
All,2017 Q1,C,Manufacturing,Repair and installation of machinery and equipment,14903,12569,2334,492,1228
All,2017 Q1,B,Mining and quarrying,Quarrying and other mining of non-metal ores,58,50,8,0,2
All,2017 Q1,D,Electricity and gas supply,Electricity and gas supply,7903,6433,1470,57,6
All,2017 Q1,E,"Sewerage, waste management and remediation services",Sewerage,186,144,42,7,28
All,2017 Q1,E,"Sewerage, waste management and remediation services","Waste collection, treatment and disposal; materials recovery",3066,2090,976,125,354
All,2017 Q1,E,"Sewerage, waste management and remediation services",Remediation and other waste management services,6,3,3,0,4
All,2017 Q1,F,Construction,Construction sites (manual workers only),117642,106091,11551,568,1377
All,2017 Q1,F,Construction,Public sector sites,50973,47579,3394,336,585
All,2017 Q1,F,Construction,Public sector building sites,21141,19475,1666,20,198
All,2017 Q1,F,Construction,Public sector civil engineering sites,29832,28104,1728,316,387
All,2017 Q1,F,Construction,Private sector sites,66669,58512,8157,232,792
All,2017 Q1,F,Construction,Private sector building sites,65559,57454,8105,232,734
All,2017 Q1,F,Construction,Private sector civil engineering sites,1110,1058,52,0,58
All,2017 Q1,G,"Import/export, wholesale and retail trades",Import and export trade,480246,246197,234049,6331,100696
All,2017 Q1,G,"Import/export, wholesale and retail trades",Wholesale,60681,37319,23362,1201,13610
All,2017 Q1,G,"Import/export, wholesale and retail trades",Retail trade,267324,104503,162821,7536,63375
All,2017 Q1,H,"Transportation, storage, postal and courier services",Land transport,45108,38345,6763,878,1725
All,2017 Q1,H,"Transportation, storage, postal and courier services",Water transport,11560,7291,4269,169,410
All,2017 Q1,H,"Transportation, storage, postal and courier services",Air transport,27764,10571,17193,329,165
All,2017 Q1,H,"Transportation, storage, postal and courier services",Warehousing and support services for transportation,79566,48966,30600,2002,6682
All,2017 Q1,H,"Transportation, storage, postal and courier services",Postal and courier services,14114,10446,3668,224,723
All,2017 Q1,I,Accommodation and food services,Accommodation services,38387,20033,18354,1870,1233
All,2017 Q1,I,Accommodation and food services,Food and beverage services,242518,110378,132140,11795,16700
All,2017 Q1,J,Information and communications,Publishing,19166,9992,9174,193,1501
All,2017 Q1,J,Information and communications,"Motion picture, video and television programme production, sound recording and music publishing; Programming and broadcasting",16540,9834,6706,425,2558
All,2017 Q1,J,Information and communications,Telecommunications,20807,13317,7490,534,321
All,2017 Q1,J,Information and communications,Information technology services,44204,32909,11295,1444,7940
All,2017 Q1,J,Information and communications,Information services,6553,3922,2631,123,1003
All,2017 Q1,K,Financing and insurance,Financial services (except insurance and pension funding),136858,66459,70399,3076,7663
All,2017 Q1,K,Financing and insurance,Insurance,16337,6613,9724,538,167
All,2017 Q1,K,Financing and insurance,Services auxiliary to financial and insurance services,70026,34911,35115,1766,16867
All,2017 Q1,K,Real estate,Real estate,130159,79440,50719,4260,16148
All,2017 Q1,M,"Professional, scientific and technical services",Legal and accounting services,54114,24378,29736,896,8208
All,2017 Q1,M,"Professional, scientific and technical services",Activities of head offices; management and management consultancy services,37115,17457,19658,815,8603
All,2017 Q1,M,"Professional, scientific and technical services","Architecture and engineering services, technical testing and analysis",41801,28170,13631,919,3422
All,2017 Q1,M,"Professional, scientific and technical services",Scientific research and development,2680,1883,797,168,227
All,2017 Q1,M,"Professional, scientific and technical services",Advertising and market research,14207,7699,6508,218,3589
All,2017 Q1,M,"Professional, scientific and technical services","Veterinary services; Other professional, scientific and technical services",24268,13168,11100,459,9347
All,2017 Q1,N,Administrative and support services,Rental and leasing services,3347,2145,1202,66,693
All,2017 Q1,N,Administrative and support services,Employment services,18096,8456,9640,534,2830
All,2017 Q1,N,Administrative and support services,"Travel agency, reservation service and related services",20651,7485,13166,482,2854
All,2017 Q1,N,Administrative and support services,Security and investigation services,51761,32412,19349,1981,235
All,2017 Q1,N,Administrative and support services,Services to buildings and landscape care,85899,29028,56871,2132,1746
All,2017 Q1,N,Administrative and support services,"Office administrative, office support and other business support services",20932,9887,11045,311,5186
All,2017 Q1,P,Education,Education,199022,72128,126894,3748,15351
All,2017 Q1,Q,Human health and social work services,Human health services,124351,33616,90735,1659,8430
All,2017 Q1,Q,Human health and social work services,Residential care services,31411,4848,26563,2589,1154
All,2017 Q1,Q,Human health and social work services,Social work services,31676,9059,22617,580,2037
All,2017 Q1,R,"Arts, entertainment and recreation",Creative and performing arts activities,4770,2587,2183,45,1942
All,2017 Q1,R,"Arts, entertainment and recreation","Libraries, archives, museums and other cultural activities",642,258,384,10,85
All,2017 Q1,R,"Arts, entertainment and recreation",Amusement parks and theme parks,5524,2985,2539,201,10
All,2017 Q1,R,"Arts, entertainment and recreation",Sports and other entertainment services,36871,18930,17941,1340,1397
All,2017 Q1,S,Other services,Activities of membership organisations,10581,4496,6085,331,1341
All,2017 Q1,S,Other services,"Repair of motor vehicles, motorcycles, computers, personal and household goods",18832,15500,3332,749,6638
All,2017 Q1,S,Other services,Other personal services,46641,13624,33017,2212,11958
All,2017 Q2,C,Manufacturing,Manufacture of food products,25552,12510,13042,936,1146
All,2017 Q2,C,Manufacturing,Manufacture of beverages,3199,2395,804,131,34
All,2017 Q2,C,Manufacturing,Manufacture of tobacco products,560,358,202,27,3
All,2017 Q2,C,Manufacturing,Manufacture of textiles,2545,1137,1408,14,436
All,2017 Q2,C,Manufacturing,Manufacture of wearing apparel,4527,2264,2263,41,639
All,2017 Q2,C,Manufacturing,"Manufacture of leather and related products; Manufacture of wood and of products of wood and cork, articles of straw and plaiting materials (except furniture and toys)",386,241,145,6,124
All,2017 Q2,C,Manufacturing,Manufacture of paper and paper products,819,592,227,7,230
All,2017 Q2,C,Manufacturing,Printing and reproduction of recorded media,14300,9445,4855,156,2317
All,2017 Q2,C,Manufacturing,Manufacture of coke and refined petroleum products; Manufacture of chemicals and chemical products,1630,954,676,6,185
All,2017 Q2,C,Manufacturing,"Manufacture of pharmaceuticals, medicinal chemical and botanical products",5122,1987,3135,190,226
All,2017 Q2,C,Manufacturing,"Manufacture of rubber and plastics products (except furniture, toys, sports goods and stationery)",2000,1213,787,53,270
All,2017 Q2,C,Manufacturing,Manufacture of other non-metallic mineral products,1483,1261,222,42,194
All,2017 Q2,C,Manufacturing,Manufacture of basic metals,1031,799,232,6,61
All,2017 Q2,C,Manufacturing,Manufacture of fabricated metal products (except machinery and equipment),2500,1867,633,68,617
All,2017 Q2,C,Manufacturing,"Manufacture of computer, electronic and optical products",2830,1620,1210,45,221
All,2017 Q2,C,Manufacturing,Manufacture of electrical equipment,1450,939,511,20,165
All,2017 Q2,C,Manufacturing,Manufacture of machinery and equipment n.e.c.,1366,1135,231,0,259
All,2017 Q2,C,Manufacturing,Body assembly of motor vehicles; Manufacture of other transport equipment,353,306,47,36,69
All,2017 Q2,C,Manufacturing,Manufacture of furniture,409,321,88,8,136
All,2017 Q2,C,Manufacturing,Other manufacturing,6583,4332,2251,66,1172
All,2017 Q2,C,Manufacturing,Repair and installation of machinery and equipment,14768,12239,2529,430,1226
All,2017 Q2,B,Mining and quarrying,Quarrying and other mining of non-metal ores,57,49,8,0,2
All,2017 Q2,D,Electricity and gas supply,Electricity and gas supply,7853,6401,1452,74,6
All,2017 Q2,E,"Sewerage, waste management and remediation services",Sewerage,162,123,39,6,27
All,2017 Q2,E,"Sewerage, waste management and remediation services","Waste collection, treatment and disposal; materials recovery",3296,2282,1014,151,356
All,2017 Q2,E,"Sewerage, waste management and remediation services",Remediation and other waste management services,6,3,3,0,4
All,2017 Q2,F,Construction,Construction sites (manual workers only),112825,100481,12344,1508,1433
All,2017 Q2,F,Construction,Public sector sites,48745,45412,3333,1324,579
All,2017 Q2,F,Construction,Public sector building sites,20189,18735,1454,0,199
All,2017 Q2,F,Construction,Public sector civil engineering sites,28556,26677,1879,1324,380
All,2017 Q2,F,Construction,Private sector sites,64080,55069,9011,184,854
All,2017 Q2,F,Construction,Private sector building sites,63176,54234,8942,184,783
All,2017 Q2,F,Construction,Private sector civil engineering sites,904,835,69,0,71
All,2017 Q2,G,"Import/export, wholesale and retail trades",Import and export trade,480314,246628,233686,6213,100785
All,2017 Q2,G,"Import/export, wholesale and retail trades",Wholesale,60667,36787,23880,1109,13595
All,2017 Q2,G,"Import/export, wholesale and retail trades",Retail trade,267796,105322,162474,7082,63466
All,2017 Q2,H,"Transportation, storage, postal and courier services",Land transport,45160,38252,6908,890,1734
All,2017 Q2,H,"Transportation, storage, postal and courier services",Water transport,11533,7166,4367,169,404
All,2017 Q2,H,"Transportation, storage, postal and courier services",Air transport,27247,10425,16822,163,162
All,2017 Q2,H,"Transportation, storage, postal and courier services",Warehousing and support services for transportation,79507,48698,30809,2086,6702
All,2017 Q2,H,"Transportation, storage, postal and courier services",Postal and courier services,14168,9249,4919,252,718
All,2017 Q2,I,Accommodation and food services,Accommodation services,38972,20129,18843,2066,1234
All,2017 Q2,I,Accommodation and food services,Food and beverage services,242562,107937,134625,11150,16610
All,2017 Q2,J,Information and communications,Publishing,18833,10144,8689,217,1505
All,2017 Q2,J,Information and communications,"Motion picture, video and television programme production, sound recording and music publishing; Programming and broadcasting",16273,9389,6884,350,2608
All,2017 Q2,J,Information and communications,Telecommunications,20471,12942,7529,566,319
All,2017 Q2,J,Information and communications,Information technology services,44337,32868,11469,1391,8085
All,2017 Q2,J,Information and communications,Information services,6667,4029,2638,186,1074
All,2017 Q2,K,Financing and insurance,Financial services (except insurance and pension funding),136655,66644,70011,3369,7706
All,2017 Q2,K,Financing and insurance,Insurance,16705,6573,10132,537,164
All,2017 Q2,K,Financing and insurance,Services auxiliary to financial and insurance services,70320,34914,35406,1838,17089
All,2017 Q2,L,Real estate,Real estate,130455,78540,51915,4210,16181
All,2017 Q2,M,"Professional, scientific and technical services",Legal and accounting services,53478,24685,28793,915,8217
All,2017 Q2,M,"Professional, scientific and technical services",Activities of head offices; management and management consultancy services,36974,18245,18729,824,8646
All,2017 Q2,M,"Professional, scientific and technical services","Architecture and engineering services, technical testing and analysis",41858,28242,13616,826,3445
All,2017 Q2,M,"Professional, scientific and technical services",Scientific research and development,2734,1871,863,176,240
All,2017 Q2,M,"Professional, scientific and technical services",Advertising and market research,14188,7296,6892,179,3571
All,2017 Q2,M,"Professional, scientific and technical services","Veterinary services; Other professional, scientific and technical services",24247,13705,10542,429,9352
All,2017 Q2,N,Administrative and support services,Rental and leasing services,3341,2133,1208,84,689
All,2017 Q2,N,Administrative and support services,Employment services,18351,7856,10495,590,2849
All,2017 Q2,N,Administrative and support services,"Travel agency, reservation service and related services",20657,8220,12437,524,2868
All,2017 Q2,N,Administrative and support services,Security and investigation services,51940,32614,19326,1828,233
All,2017 Q2,N,Administrative and support services,Services to buildings and landscape care,85733,28614,57119,1901,1754
All,2017 Q2,N,Administrative and support services,"Office administrative, office support and other business support services",20922,9991,10931,313,5180
All,2017 Q2,P,Education,Education,198773,70366,128407,3642,15382
All,2017 Q2,Q,Human health and social work services,Human health services,124223,34049,90174,1788,8451
All,2017 Q2,Q,Human health and social work services,Residential care services,31735,5137,26598,2526,1160
All,2017 Q2,Q,Human health and social work services,Social work services,31483,7950,23533,620,2046
All,2017 Q2,R,"Arts, entertainment and recreation",Creative and performing arts activities,4663,2508,2155,77,1938
All,2017 Q2,R,"Arts, entertainment and recreation","Libraries, archives, museums and other cultural activities",608,256,352,7,88
All,2017 Q2,R,"Arts, entertainment and recreation",Amusement parks and theme parks,5832,3172,2660,221,10
All,2017 Q2,R,"Arts, entertainment and recreation",Sports and other entertainment services,37015,18947,18068,1253,1412
All,2017 Q2,S,Other services,Activities of membership organisations,10716,4937,5779,355,1336
All,2017 Q2,S,Other services,"Repair of motor vehicles, motorcycles, computers, personal and household goods",19073,15609,3464,598,6645
All,2017 Q2,S,Other services,Other personal services,46646,13463,33183,2045,11966
All,2017 Q3,C,Manufacturing,Manufacture of food products,25671,13446,12225,960,1223
All,2017 Q3,C,Manufacturing,Manufacture of beverages,3258,2418,840,173,35
All,2017 Q3,C,Manufacturing,Manufacture of tobacco products,556,360,196,33,3
All,2017 Q3,C,Manufacturing,Manufacture of textiles,2370,1192,1178,6,418
All,2017 Q3,C,Manufacturing,Manufacture of wearing apparel,4077,1861,2216,18,617
All,2017 Q3,C,Manufacturing,"Manufacture of leather and related products; Manufacture of wood and of products of wood and cork, articles of straw and plaiting materials (except furniture and toys)",387,269,118,18,122
All,2017 Q3,C,Manufacturing,Manufacture of paper and paper products,786,593,193,4,223
All,2017 Q3,C,Manufacturing,Printing and reproduction of recorded media,14059,9007,5052,87,2261
All,2017 Q3,C,Manufacturing,Manufacture of coke and refined petroleum products; Manufacture of chemicals and chemical products,1577,909,668,1,181
All,2017 Q3,C,Manufacturing,"Manufacture of pharmaceuticals, medicinal chemical and botanical products",5195,2152,3043,105,226
All,2017 Q3,C,Manufacturing,"Manufacture of rubber and plastics products (except furniture, toys, sports goods and stationery)",2088,1348,740,64,272
All,2017 Q3,C,Manufacturing,Manufacture of other non-metallic mineral products,1457,1212,245,22,194
All,2017 Q3,C,Manufacturing,Manufacture of basic metals,1063,835,228,20,60
All,2017 Q3,C,Manufacturing,Manufacture of fabricated metal products (except machinery and equipment),2416,1708,708,77,609
All,2017 Q3,C,Manufacturing,"Manufacture of computer, electronic and optical products",2646,1411,1235,40,215
All,2017 Q3,C,Manufacturing,Manufacture of electrical equipment,1366,902,464,34,158
All,2017 Q3,C,Manufacturing,Manufacture of machinery and equipment n.e.c.,1396,1097,299,10,249
All,2017 Q3,C,Manufacturing,Body assembly of motor vehicles; Manufacture of other transport equipment,357,291,66,16,70
All,2017 Q3,C,Manufacturing,Manufacture of furniture,377,306,71,1,130
All,2017 Q3,C,Manufacturing,Other manufacturing,6202,3851,2351,114,1162
All,2017 Q3,C,Manufacturing,Repair and installation of machinery and equipment,14732,12267,2465,435,1220
All,2017 Q3,B,Mining and quarrying,Quarrying and other mining of non-metal ores,54,46,8,0,2
All,2017 Q3,D,Electricity and gas supply,Electricity and gas supply,7921,6442,1479,59,6
All,2017 Q3,E,"Sewerage, waste management and remediation services",Sewerage,145,112,33,3,24
All,2017 Q3,E,"Sewerage, waste management and remediation services","Waste collection, treatment and disposal; materials recovery",3180,2202,978,147,360
All,2017 Q3,E,"Sewerage, waste management and remediation services",Remediation and other waste management services,6,3,3,0,4
All,2017 Q3,F,Construction,Construction sites (manual workers only),121466,108324,13142,831,1456
All,2017 Q3,F,Construction,Public sector sites,53810,50198,3612,768,566
All,2017 Q3,F,Construction,Public sector building sites,22388,20687,1701,0,206
All,2017 Q3,F,Construction,Public sector civil engineering sites,31422,29511,1911,768,360
All,2017 Q3,F,Construction,Private sector sites,67656,58126,9530,63,890
All,2017 Q3,F,Construction,Private sector building sites,66764,57269,9495,63,813
All,2017 Q3,F,Construction,Private sector civil engineering sites,892,857,35,0,77
All,2017 Q3,G,"Import/export, wholesale and retail trades",Import and export trade,478847,249713,229134,6295,100648
All,2017 Q3,G,"Import/export, wholesale and retail trades",Wholesale,60519,36651,23868,1319,13587
All,2017 Q3,G,"Import/export, wholesale and retail trades",Retail trade,267131,104321,162810,8130,63055
All,2017 Q3,H,"Transportation, storage, postal and courier services",Land transport,45086,38268,6818,677,1737
All,2017 Q3,H,"Transportation, storage, postal and courier services",Water transport,11473,7089,4384,168,388
All,2017 Q3,H,"Transportation, storage, postal and courier services",Air transport,28211,10579,17632,385,162
All,2017 Q3,H,"Transportation, storage, postal and courier services",Warehousing and support services for transportation,80179,49602,30577,2030,6703
All,2017 Q3,H,"Transportation, storage, postal and courier services",Postal and courier services,14049,9727,4322,338,733
All,2017 Q3,I,Accommodation and food services,Accommodation services,39252,20538,18714,1850,1239
All,2017 Q3,I,Accommodation and food services,Food and beverage services,244113,110358,133755,10777,16753
All,2017 Q3,J,Information and communications,Publishing,18731,10057,8674,242,1513
All,2017 Q3,J,Information and communications,"Motion picture, video and television programme production, sound recording and music publishing; Programming and broadcasting",16485,9668,6817,374,2692
All,2017 Q3,J,Information and communications,Telecommunications,20173,12740,7433,535,325
All,2017 Q3,J,Information and communications,Information technology services,44450,34486,9964,1455,8307
All,2017 Q3,J,Information and communications,Information services,6784,3913,2871,144,1136
All,2017 Q3,K,Financing and insurance,Financial services (except insurance and pension funding),137291,66394,70897,3020,7798
All,2017 Q3,K,Financing and insurance,Insurance,17070,6845,10225,618,173
All,2017 Q3,K,Financing and insurance,Services auxiliary to financial and insurance services,70602,35468,35134,1869,17524
All,2017 Q3,L,Real estate,Real estate,131400,78673,52727,4141,16313
All,2017 Q3,M,"Professional, scientific and technical services",Legal and accounting services,53827,24358,29469,865,8266
All,2017 Q3,M,"Professional, scientific and technical services",Activities of head offices; management and management consultancy services,37495,18543,18952,830,8765
All,2017 Q3,M,"Professional, scientific and technical services","Architecture and engineering services, technical testing and analysis",41911,27602,14309,891,3444
All,2017 Q3,M,"Professional, scientific and technical services",Scientific research and development,2774,1450,1324,171,253
All,2017 Q3,M,"Professional, scientific and technical services",Advertising and market research,14205,7581,6624,185,3581
All,2017 Q3,M,"Professional, scientific and technical services","Veterinary services; Other professional, scientific and technical services",24333,13623,10710,417,9360
All,2017 Q3,N,Administrative and support services,Rental and leasing services,3392,2200,1192,94,700
All,2017 Q3,N,Administrative and support services,Employment services,18391,7195,11196,478,2858
All,2017 Q3,N,Administrative and support services,"Travel agency, reservation service and related services",20519,8644,11875,484,2864
All,2017 Q3,N,Administrative and support services,Security and investigation services,51592,33395,18197,1919,229
All,2017 Q3,N,Administrative and support services,Services to buildings and landscape care,85210,30025,55185,1934,1775
All,2017 Q3,N,Administrative and support services,"Office administrative, office support and other business support services",20927,9668,11259,321,5173
All,2017 Q3,P,Education,Education,198686,71759,126927,3864,15516
All,2017 Q3,Q,Human health and social work services,Human health services,125752,34858,90894,2843,8498
All,2017 Q3,Q,Human health and social work services,Residential care services,31901,4834,27067,2725,1170
All,2017 Q3,Q,Human health and social work services,Social work services,31397,7765,23632,788,2066
All,2017 Q3,R,"Arts, entertainment and recreation",Creative and performing arts activities,4755,2362,2393,55,1925
All,2017 Q3,R,"Arts, entertainment and recreation","Libraries, archives, museums and other cultural activities",628,232,396,6,89
All,2017 Q3,R,"Arts, entertainment and recreation",Amusement parks and theme parks,6493,3555,2938,256,10
All,2017 Q3,R,"Arts, entertainment and recreation",Sports and other entertainment services,36442,18257,18185,1568,1412
All,2017 Q3,S,Other services,Activities of membership organisations,10781,5269,5512,395,1335
All,2017 Q3,S,Other services,"Repair of motor vehicles, motorcycles, computers, personal and household goods",19058,15626,3432,571,6652
All,2017 Q3,S,Other services,Other personal services,46647,12490,34157,1844,11947
All,2017 Q4,C,Manufacturing,Manufacture of food products,25805,12097,13708,956,1255
All,2017 Q4,C,Manufacturing,Manufacture of beverages,3166,2357,809,186,37
All,2017 Q4,C,Manufacturing,Manufacture of tobacco products,533,347,186,4,3
All,2017 Q4,C,Manufacturing,Manufacture of textiles,2348,1180,1168,13,427
All,2017 Q4,C,Manufacturing,Manufacture of wearing apparel,4066,2004,2062,10,609
All,2017 Q4,C,Manufacturing,"Manufacture of leather and related products; Manufacture of wood and of products of wood and cork, articles of straw and plaiting materials (except furniture and toys)",348,253,95,7,115
All,2017 Q4,C,Manufacturing,Manufacture of paper and paper products,735,452,283,2,201
All,2017 Q4,C,Manufacturing,Printing and reproduction of recorded media,13724,8426,5298,85,2212
All,2017 Q4,C,Manufacturing,Manufacture of coke and refined petroleum products; Manufacture of chemicals and chemical products,1553,1023,530,6,179
All,2017 Q4,C,Manufacturing,"Manufacture of pharmaceuticals, medicinal chemical and botanical products",5295,2333,2962,233,224
All,2017 Q4,C,Manufacturing,"Manufacture of rubber and plastics products (except furniture, toys, sports goods and stationery)",2095,1394,701,33,269
All,2017 Q4,C,Manufacturing,Manufacture of other non-metallic mineral products,1514,1242,272,26,194
All,2017 Q4,C,Manufacturing,Manufacture of basic metals,1106,888,218,13,60
All,2017 Q4,C,Manufacturing,Manufacture of fabricated metal products (except machinery and equipment),2393,1789,604,49,604
All,2017 Q4,C,Manufacturing,"Manufacture of computer, electronic and optical products",2600,1326,1274,36,199
All,2017 Q4,C,Manufacturing,Manufacture of electrical equipment,1318,899,419,35,157
All,2017 Q4,C,Manufacturing,Manufacture of machinery and equipment n.e.c.,1337,1135,202,4,251
All,2017 Q4,C,Manufacturing,Body assembly of motor vehicles; Manufacture of other transport equipment,330,268,62,4,70
All,2017 Q4,C,Manufacturing,Manufacture of furniture,366,254,112,19,133
All,2017 Q4,C,Manufacturing,Other manufacturing,5933,3619,2314,93,1153
All,2017 Q4,C,Manufacturing,Repair and installation of machinery and equipment,14877,12282,2595,791,1201
All,2017 Q4,B,Mining and quarrying,Quarrying and other mining of non-metal ores,49,43,6,0,2
All,2017 Q4,D,Electricity and gas supply,Electricity and gas supply,7988,6465,1523,67,9
All,2017 Q4,E,"Sewerage, waste management and remediation services",Sewerage,155,118,37,3,25
All,2017 Q4,E,"Sewerage, waste management and remediation services","Waste collection, treatment and disposal; materials recovery",3081,1936,1145,206,359
All,2017 Q4,E,"Sewerage, waste management and remediation services",Remediation and other waste management services,4,3,1,0,4
All,2017 Q4,F,Construction,Construction sites (manual workers only),122761,109785,12976,1374,1439
All,2017 Q4,F,Construction,Public sector sites,53309,49833,3476,1264,608
All,2017 Q4,F,Construction,Public sector building sites,22921,21319,1602,23,211
All,2017 Q4,F,Construction,Public sector civil engineering sites,30388,28514,1874,1241,397
All,2017 Q4,F,Construction,Private sector sites,69452,59952,9500,110,831
All,2017 Q4,F,Construction,Private sector building sites,68442,59023,9419,110,755
All,2017 Q4,F,Construction,Private sector civil engineering sites,1010,929,81,0,76
All,2017 Q4,G,"Import/export, wholesale and retail trades",Import and export trade,477820,247911,229909,5982,100523
All,2017 Q4,G,"Import/export, wholesale and retail trades",Wholesale,60415,35510,24905,1165,13574
All,2017 Q4,G,"Import/export, wholesale and retail trades",Retail trade,269264,107117,162147,7798,63222
All,2017 Q4,H,"Transportation, storage, postal and courier services",Land transport,44705,38284,6421,626,1719
All,2017 Q4,H,"Transportation, storage, postal and courier services",Water transport,11455,6968,4487,141,401
All,2017 Q4,H,"Transportation, storage, postal and courier services",Air transport,29031,10960,18071,233,160
All,2017 Q4,H,"Transportation, storage, postal and courier services",Warehousing and support services for transportation,80889,50231,30658,2140,6795
All,2017 Q4,H,"Transportation, storage, postal and courier services",Postal and courier services,14171,10088,4083,307,758
All,2017 Q4,I,Accommodation and food services,Accommodation services,39884,20964,18920,1795,1242
All,2017 Q4,I,Accommodation and food services,Food and beverage services,243621,107895,135726,12116,16917
All,2017 Q4,J,Information and communications,Publishing,18745,10152,8593,308,1525
All,2017 Q4,J,Information and communications,"Motion picture, video and television programme production, sound recording and music publishing; Programming and broadcasting",16456,9810,6646,381,2750
All,2017 Q4,J,Information and communications,Telecommunications,20293,12875,7418,491,338
All,2017 Q4,J,Information and communications,Information technology services,44829,33586,11243,1428,8381
All,2017 Q4,J,Information and communications,Information services,6799,4102,2697,157,1115
All,2017 Q4,K,Financing and insurance,Financial services (except insurance and pension funding),138289,67014,71275,3242,7906
All,2017 Q4,K,Financing and insurance,Insurance,17462,7088,10374,612,177
All,2017 Q4,K,Financing and insurance,Services auxiliary to financial and insurance services,71405,36105,35300,1811,17709
All,2017 Q4,L,Real estate,Real estate,131855,79019,52836,3764,16486
All,2017 Q4,M,"Professional, scientific and technical services",Legal and accounting services,54307,24280,30027,976,8359
All,2017 Q4,M,"Professional, scientific and technical services",Activities of head offices; management and management consultancy services,38607,19130,19477,902,8788
All,2017 Q4,M,"Professional, scientific and technical services","Architecture and engineering services, technical testing and analysis",41884,27921,13963,713,3488
All,2017 Q4,M,"Professional, scientific and technical services",Scientific research and development,2831,1433,1398,185,261
All,2017 Q4,M,"Professional, scientific and technical services",Advertising and market research,14372,7245,7127,291,3613
All,2017 Q4,M,"Professional, scientific and technical services","Veterinary services; Other professional, scientific and technical services",24777,14090,10687,498,9408
All,2017 Q4,N,Administrative and support services,Rental and leasing services,3405,2261,1144,67,703
All,2017 Q4,N,Administrative and support services,Employment services,18951,8318,10633,515,2876
All,2017 Q4,N,Administrative and support services,"Travel agency, reservation service and related services",20469,8365,12104,479,2870
All,2017 Q4,N,Administrative and support services,Security and investigation services,52076,33438,18638,1850,232
All,2017 Q4,N,Administrative and support services,Services to buildings and landscape care,84892,29600,55292,1969,1796
All,2017 Q4,N,Administrative and support services,"Office administrative, office support and other business support services",21088,9898,11190,409,5197
All,2017 Q4,P,Education,Education,201488,73513,127975,3926,15693
All,2017 Q4,Q,Human health and social work services,Human health services,127350,34465,92885,4143,8519
All,2017 Q4,Q,Human health and social work services,Residential care services,32206,5214,26992,2895,1171
All,2017 Q4,Q,Human health and social work services,Social work services,31256,7665,23591,749,2072
All,2017 Q4,R,"Arts, entertainment and recreation",Creative and performing arts activities,4820,2680,2140,97,1901
All,2017 Q4,R,"Arts, entertainment and recreation","Libraries, archives, museums and other cultural activities",652,247,405,5,89
All,2017 Q4,R,"Arts, entertainment and recreation",Amusement parks and theme parks,6041,3255,2786,284,12
All,2017 Q4,R,"Arts, entertainment and recreation",Sports and other entertainment services,36694,18576,18118,1513,1423
All,2017 Q4,S,Other services,Activities of membership organisations,10766,4714,6052,421,1347
All,2017 Q4,S,Other services,"Repair of motor vehicles, motorcycles, computers, personal and household goods",18903,15541,3362,417,6675
All,2017 Q4,S,Other services,Other personal services,47197,13078,34119,1985,12103
All,2018 Q1,C,Manufacturing,Manufacture of food products,25686,12158,13528,1076,1311
All,2018 Q1,C,Manufacturing,Manufacture of beverages,3166,2314,852,219,38
All,2018 Q1,C,Manufacturing,Manufacture of tobacco products,532,346,186,37,3
All,2018 Q1,C,Manufacturing,Manufacture of textiles,2322,1079,1243,12,416
All,2018 Q1,C,Manufacturing,Manufacture of wearing apparel,4027,2022,2005,15,603
All,2018 Q1,C,Manufacturing,"Manufacture of leather and related products; Manufacture of wood and of products of wood and cork, articles of straw and plaiting materials (except furniture and toys)",349,231,118,6,114
All,2018 Q1,C,Manufacturing,Manufacture of paper and paper products,760,511,249,3,217
All,2018 Q1,C,Manufacturing,Printing and reproduction of recorded media,13626,8740,4886,118,2208
All,2018 Q1,C,Manufacturing,Manufacture of coke and refined petroleum products; Manufacture of chemicals and chemical products,1581,1015,566,14,179
All,2018 Q1,C,Manufacturing,"Manufacture of pharmaceuticals, medicinal chemical and botanical products",5162,1924,3238,185,221
All,2018 Q1,C,Manufacturing,"Manufacture of rubber and plastics products (except furniture, toys, sports goods and stationery)",2062,1387,675,31,264
All,2018 Q1,C,Manufacturing,Manufacture of other non-metallic mineral products,1523,1267,256,54,193
All,2018 Q1,C,Manufacturing,Manufacture of basic metals,1060,833,227,17,60
All,2018 Q1,C,Manufacturing,Manufacture of fabricated metal products (except machinery and equipment),2332,1837,495,28,600
All,2018 Q1,C,Manufacturing,"Manufacture of computer, electronic and optical products",2518,1305,1213,36,197
All,2018 Q1,C,Manufacturing,Manufacture of electrical equipment,1339,982,357,41,156
All,2018 Q1,C,Manufacturing,Manufacture of machinery and equipment n.e.c.,1350,1191,159,7,248
All,2018 Q1,C,Manufacturing,Body assembly of motor vehicles; Manufacture of other transport equipment,326,281,45,13,70
All,2018 Q1,C,Manufacturing,Manufacture of furniture,373,299,74,4,131
All,2018 Q1,C,Manufacturing,Other manufacturing,5922,3864,2058,62,1147
All,2018 Q1,C,Manufacturing,Repair and installation of machinery and equipment,14853,12299,2554,631,1194
All,2018 Q1,B,Mining and quarrying,Quarrying and other mining of non-metal ores,38,33,5,0,2
All,2018 Q1,D,Electricity and gas supply,Electricity and gas supply,8004,6459,1545,76,10
All,2018 Q1,E,"Sewerage, waste management and remediation services",Sewerage,154,117,37,9,25
All,2018 Q1,E,"Sewerage, waste management and remediation services","Waste collection, treatment and disposal; materials recovery",3038,2065,973,117,358
All,2018 Q1,E,"Sewerage, waste management and remediation services",Remediation and other waste management services,6,3,3,0,4
All,2018 Q1,F,Construction,Construction sites (manual workers only),120723,107585,13138,851,1457
All,2018 Q1,F,Construction,Public sector sites,51381,47761,3620,778,618
All,2018 Q1,F,Construction,Public sector building sites,22491,20881,1610,11,235
All,2018 Q1,F,Construction,Public sector civil engineering sites,28890,26880,2010,767,383
All,2018 Q1,F,Construction,Private sector sites,69342,59824,9518,73,839
All,2018 Q1,F,Construction,Private sector building sites,67872,58474,9398,56,766
All,2018 Q1,F,Construction,Private sector civil engineering sites,1470,1350,120,17,73
All,2018 Q1,G,"Import/export, wholesale and retail trades",Import and export trade,478005,246577,231428,6286,100590
All,2018 Q1,G,"Import/export, wholesale and retail trades",Wholesale,60389,35750,24639,1309,13576
All,2018 Q1,G,"Import/export, wholesale and retail trades",Retail trade,270951,107819,163132,8110,64251
All,2018 Q1,H,"Transportation, storage, postal and courier services",Land transport,44378,37793,6585,780,1685
All,2018 Q1,H,"Transportation, storage, postal and courier services",Water transport,11689,7202,4487,196,393
All,2018 Q1,H,"Transportation, storage, postal and courier services",Air transport,28557,10789,17768,296,164
All,2018 Q1,H,"Transportation, storage, postal and courier services",Warehousing and support services for transportation,80379,49367,31012,2457,6848
All,2018 Q1,H,"Transportation, storage, postal and courier services",Postal and courier services,14238,10216,4022,313,776
All,2018 Q1,I,Accommodation and food services,Accommodation services,39586,20821,18765,2348,1258
All,2018 Q1,I,Accommodation and food services,Food and beverage services,246611,108354,138257,12031,17230
All,2018 Q1,J,Information and communications,Publishing,18797,9615,9182,326,1521
All,2018 Q1,J,Information and communications,"Motion picture, video and television programme production, sound recording and music publishing; Programming and broadcasting",16281,9643,6638,481,2744
All,2018 Q1,J,Information and communications,Telecommunications,19923,12372,7551,590,339
All,2018 Q1,J,Information and communications,Information technology services,45010,34169,10841,1472,8479
All,2018 Q1,J,Information and communications,Information services,6905,3921,2984,248,1117
All,2018 Q1,K,Financing and insurance,Financial services (except insurance and pension funding),139402,68103,71299,3432,7957
All,2018 Q1,K,Financing and insurance,Insurance,17471,7097,10374,649,176
All,2018 Q1,K,Financing and insurance,Services auxiliary to financial and insurance services,72018,35709,36309,2009,17910
All,2018 Q1,L,Real estate,Real estate,132503,79755,52748,4199,16619
All,2018 Q1,M,"Professional, scientific and technical services",Legal and accounting services,54791,25908,28883,987,8351
All,2018 Q1,M,"Professional, scientific and technical services",Activities of head offices; management and management consultancy services,39157,18879,20278,1105,8868
All,2018 Q1,M,"Professional, scientific and technical services","Architecture and engineering services, technical testing and analysis",41939,27762,14177,801,3504
All,2018 Q1,M,"Professional, scientific and technical services",Scientific research and development,2851,1456,1395,187,267
All,2018 Q1,M,"Professional, scientific and technical services",Advertising and market research,14387,7445,6942,288,3613
All,2018 Q1,M,"Professional, scientific and technical services","Veterinary services; Other professional, scientific and technical services",25025,14074,10951,663,9470
All,2018 Q1,N,Administrative and support services,Rental and leasing services,3528,2353,1175,83,746
All,2018 Q1,N,Administrative and support services,Employment services,19374,8141,11233,574,2976
All,2018 Q1,N,Administrative and support services,"Travel agency, reservation service and related services",20137,7581,12556,413,2897
All,2018 Q1,N,Administrative and support services,Security and investigation services,54184,34743,19441,2037,230
All,2018 Q1,N,Administrative and support services,Services to buildings and landscape care,84587,30061,54526,1995,1824
All,2018 Q1,N,Administrative and support services,"Office administrative, office support and other business support services",21472,9522,11950,408,5286
All,2018 Q1,P,Education,Education,202976,72259,130717,4089,15783
All,2018 Q1,Q,Human health and social work services,Human health services,128441,34548,93893,3298,8561
All,2018 Q1,Q,Human health and social work services,Residential care services,32048,5045,27003,2883,1162
All,2018 Q1,Q,Human health and social work services,Social work services,31532,8343,23189,754,2072
All,2018 Q1,R,"Arts, entertainment and recreation",Creative and performing arts activities,4726,2526,2200,93,1914
All,2018 Q1,R,"Arts, entertainment and recreation","Libraries, archives, museums and other cultural activities",660,272,388,18,90
All,2018 Q1,R,"Arts, entertainment and recreation",Amusement parks and theme parks,5905,3177,2728,289,12
All,2018 Q1,R,"Arts, entertainment and recreation",Sports and other entertainment services,36455,18001,18454,1680,1440
All,2018 Q1,S,Other services,Activities of membership organisations,10781,4910,5871,419,1349
All,2018 Q1,S,Other services,"Repair of motor vehicles, motorcycles, computers, personal and household goods",19177,15859,3318,561,6646
All,2018 Q1,S,Other services,Other personal services,47325,13533,33792,2056,12192
All,2018 Q2,C,Manufacturing,Manufacture of food products,25472,12291,13181,1159,1343
All,2018 Q2,C,Manufacturing,Manufacture of beverages,3295,2279,1016,197,39
All,2018 Q2,C,Manufacturing,Manufacture of tobacco products,534,346,188,38,3
All,2018 Q2,C,Manufacturing,Manufacture of textiles,2274,1173,1101,6,402
All,2018 Q2,C,Manufacturing,Manufacture of wearing apparel,3886,1897,1989,16,590
All,2018 Q2,C,Manufacturing,"Manufacture of leather and related products; Manufacture of wood and of products of wood and cork, articles of straw and plaiting materials (except furniture and toys)",353,219,134,4,117
All,2018 Q2,C,Manufacturing,Manufacture of paper and paper products,746,532,214,8,213
All,2018 Q2,C,Manufacturing,Printing and reproduction of recorded media,13243,8735,4508,134,2176
All,2018 Q2,C,Manufacturing,Manufacture of coke and refined petroleum products; Manufacture of chemicals and chemical products,1496,1010,486,33,178
All,2018 Q2,C,Manufacturing,"Manufacture of pharmaceuticals, medicinal chemical and botanical products",5245,2007,3238,242,223
All,2018 Q2,C,Manufacturing,"Manufacture of rubber and plastics products (except furniture, toys, sports goods and stationery)",2037,1194,843,57,257
All,2018 Q2,C,Manufacturing,Manufacture of other non-metallic mineral products,1582,1265,317,74,190
All,2018 Q2,C,Manufacturing,Manufacture of basic metals,1034,825,209,11,60
All,2018 Q2,C,Manufacturing,Manufacture of fabricated metal products (except machinery and equipment),2343,1805,538,5,595
All,2018 Q2,C,Manufacturing,"Manufacture of computer, electronic and optical products",2457,1300,1157,26,185
All,2018 Q2,C,Manufacturing,Manufacture of electrical equipment,1295,897,398,38,154
All,2018 Q2,C,Manufacturing,Manufacture of machinery and equipment n.e.c.,1411,1217,194,5,245
All,2018 Q2,C,Manufacturing,Body assembly of motor vehicles; Manufacture of other transport equipment,332,289,43,15,72
All,2018 Q2,C,Manufacturing,Manufacture of furniture,366,308,58,0,128
All,2018 Q2,C,Manufacturing,Other manufacturing,5830,3708,2122,105,1133
All,2018 Q2,C,Manufacturing,Repair and installation of machinery and equipment,14602,12236,2366,776,1187
All,2018 Q2,B,Mining and quarrying,Quarrying and other mining of non-metal ores,30,30,0,0,1
All,2018 Q2,D,Electricity and gas supply,Electricity and gas supply,7947,6435,1512,84,10
All,2018 Q2,E,"Sewerage, waste management and remediation services",Sewerage,152,115,37,6,25
All,2018 Q2,E,"Sewerage, waste management and remediation services","Waste collection, treatment and disposal; materials recovery",3062,2126,936,151,356
All,2018 Q2,E,"Sewerage, waste management and remediation services",Remediation and other waste management services,4,3,1,0,4
All,2018 Q2,F,Construction,Construction sites (manual workers only),116051,101674,14377,580,1489
All,2018 Q2,F,Construction,Public sector sites,46468,43039,3429,468,608
All,2018 Q2,F,Construction,Public sector building sites,22103,20249,1854,8,235
All,2018 Q2,F,Construction,Public sector civil engineering sites,24365,22790,1575,460,373
All,2018 Q2,F,Construction,Private sector sites,69583,58635,10948,112,881
All,2018 Q2,F,Construction,Private sector building sites,68108,57286,10822,112,806
All,2018 Q2,F,Construction,Private sector civil engineering sites,1475,1349,126,0,75
All,2018 Q2,G,"Import/export, wholesale and retail trades",Import and export trade,477613,247640,229973,6442,100496
All,2018 Q2,G,"Import/export, wholesale and retail trades",Wholesale,60109,36539,23570,1336,13526
All,2018 Q2,G,"Import/export, wholesale and retail trades",Retail trade,272111,107045,165066,7980,64343
All,2018 Q2,H,"Transportation, storage, postal and courier services",Land transport,44421,37625,6796,1286,1688
All,2018 Q2,H,"Transportation, storage, postal and courier services",Water transport,11582,7123,4459,208,396
All,2018 Q2,H,"Transportation, storage, postal and courier services",Air transport,28362,10831,17531,325,169
All,2018 Q2,H,"Transportation, storage, postal and courier services",Warehousing and support services for transportation,81066,51317,29749,2416,7000
All,2018 Q2,H,"Transportation, storage, postal and courier services",Postal and courier services,14338,10310,4028,424,811
All,2018 Q2,I,Accommodation and food services,Accommodation services,40720,21216,19504,2302,1257
All,2018 Q2,I,Accommodation and food services,Food and beverage services,249872,110076,139796,12056,17652
All,2018 Q2,J,Information and communications,Publishing,19071,10441,8630,459,1535
All,2018 Q2,J,Information and communications,"Motion picture, video and television programme production, sound recording and music publishing; Programming and broadcasting",16362,9253,7109,471,2787
All,2018 Q2,J,Information and communications,Telecommunications,19987,12458,7529,511,353
All,2018 Q2,J,Information and communications,Information technology services,45787,34359,11428,1533,8606
All,2018 Q2,J,Information and communications,Information services,7022,4409,2613,275,1134
All,2018 Q2,K,Financing and insurance,Financial services (except insurance and pension funding),138682,67577,71105,3426,8050
All,2018 Q2,K,Financing and insurance,Insurance,17577,7031,10546,810,172
All,2018 Q2,K,Financing and insurance,Services auxiliary to financial and insurance services,72694,37105,35589,1974,18069
All,2018 Q2,L,Real estate,Real estate,133054,78356,54698,4280,16726
All,2018 Q2,M,"Professional, scientific and technical services",Legal and accounting services,54738,24647,30091,1045,8388
All,2018 Q2,M,"Professional, scientific and technical services",Activities of head offices; management and management consultancy services,39531,19162,20369,1083,8930
All,2018 Q2,M,"Professional, scientific and technical services","Architecture and engineering services, technical testing and analysis",42132,27884,14248,713,3527
All,2018 Q2,M,"Professional, scientific and technical services",Scientific research and development,2931,1526,1405,175,280
All,2018 Q2,M,"Professional, scientific and technical services",Advertising and market research,14622,7697,6925,302,3627
All,2018 Q2,M,"Professional, scientific and technical services","Veterinary services; Other professional, scientific and technical services",25347,14811,10536,591,9532
All,2018 Q2,N,Administrative and support services,Rental and leasing services,3537,2247,1290,98,751
All,2018 Q2,N,Administrative and support services,Employment services,19526,7662,11864,575,3002
All,2018 Q2,N,Administrative and support services,"Travel agency, reservation service and related services",19791,7515,12276,400,2891
All,2018 Q2,N,Administrative and support services,Security and investigation services,54544,35374,19170,2156,235
All,2018 Q2,N,Administrative and support services,Services to buildings and landscape care,84448,29706,54742,1960,1813
All,2018 Q2,N,Administrative and support services,"Office administrative, office support and other business support services",21514,9924,11590,572,5280
All,2018 Q2,P,Education,Education,202469,72021,130448,4227,15968
All,2018 Q2,Q,Human health and social work services,Human health services,128505,34885,93620,3772,8662
All,2018 Q2,Q,Human health and social work services,Residential care services,32632,5086,27546,3042,1156
All,2018 Q2,Q,Human health and social work services,Social work services,31603,7617,23986,814,2083
All,2018 Q2,R,"Arts, entertainment and recreation",Creative and performing arts activities,4722,2496,2226,99,1911
All,2018 Q2,R,"Arts, entertainment and recreation","Libraries, archives, museums and other cultural activities",702,226,476,18,90
All,2018 Q2,R,"Arts, entertainment and recreation",Amusement parks and theme parks,6714,3378,3336,598,12
All,2018 Q2,R,"Arts, entertainment and recreation",Sports and other entertainment services,36702,18792,17910,1676,1447
All,2018 Q2,S,Other services,Activities of membership organisations,11024,5230,5794,402,1374
All,2018 Q2,S,Other services,"Repair of motor vehicles, motorcycles, computers, personal and household goods",19261,15441,3820,680,6710
All,2018 Q2,S,Other services,Other personal services,47036,13725,33311,1921,12324
All,2018 Q3,C,Manufacturing,Manufacture of food products,26231,13089,13142,1179,1370
All,2018 Q3,C,Manufacturing,Manufacture of beverages,3309,2438,871,252,39
All,2018 Q3,C,Manufacturing,Manufacture of tobacco products,541,350,191,32,3
All,2018 Q3,C,Manufacturing,Manufacture of textiles,2119,965,1154,26,387
All,2018 Q3,C,Manufacturing,Manufacture of wearing apparel,3752,1383,2369,18,570
All,2018 Q3,C,Manufacturing,"Manufacture of leather and related products; Manufacture of wood and of products of wood and cork, articles of straw and plaiting materials (except furniture and toys)",367,251,116,2,118
All,2018 Q3,C,Manufacturing,Manufacture of paper and paper products,713,501,212,14,210
All,2018 Q3,C,Manufacturing,Printing and reproduction of recorded media,12967,8458,4509,118,2135
All,2018 Q3,C,Manufacturing,Manufacture of coke and refined petroleum products; Manufacture of chemicals and chemical products,1543,959,584,16,179
All,2018 Q3,C,Manufacturing,"Manufacture of pharmaceuticals, medicinal chemical and botanical products",5247,1977,3270,233,224
All,2018 Q3,C,Manufacturing,"Manufacture of rubber and plastics products (except furniture, toys, sports goods and stationery)",1983,1262,721,98,248
All,2018 Q3,C,Manufacturing,Manufacture of other non-metallic mineral products,1629,1310,319,42,193
All,2018 Q3,C,Manufacturing,Manufacture of basic metals,971,757,214,12,60
All,2018 Q3,C,Manufacturing,Manufacture of fabricated metal products (except machinery and equipment),2294,1701,593,43,577
All,2018 Q3,C,Manufacturing,"Manufacture of computer, electronic and optical products",2330,1233,1097,33,184
All,2018 Q3,C,Manufacturing,Manufacture of electrical equipment,1269,919,350,30,153
All,2018 Q3,C,Manufacturing,Manufacture of machinery and equipment n.e.c.,1378,1127,251,2,231
All,2018 Q3,C,Manufacturing,Body assembly of motor vehicles; Manufacture of other transport equipment,350,296,54,5,72
All,2018 Q3,C,Manufacturing,Manufacture of furniture,349,293,56,2,124
All,2018 Q3,C,Manufacturing,Other manufacturing,5563,3446,2117,124,1114
All,2018 Q3,C,Manufacturing,Repair and installation of machinery and equipment,14537,12279,2258,616,1192
All,2018 Q3,B,Mining and quarrying,Quarrying and other mining of non-metal ores,30,30,0,0,1
All,2018 Q3,D,Electricity and gas supply,Electricity and gas supply,7946,6418,1528,93,10
All,2018 Q3,E,"Sewerage, waste management and remediation services",Sewerage,159,119,40,4,25
All,2018 Q3,E,"Sewerage, waste management and remediation services","Waste collection, treatment and disposal; materials recovery",3269,2205,1064,135,366
All,2018 Q3,E,"Sewerage, waste management and remediation services",Remediation and other waste management services,4,3,1,0,4
All,2018 Q3,F,Construction,Construction sites (manual workers only),107603,95174,12429,515,1505
All,2018 Q3,F,Construction,Public sector sites,42114,38771,3343,459,618
All,2018 Q3,F,Construction,Public sector building sites,21264,19354,1910,18,254
All,2018 Q3,F,Construction,Public sector civil engineering sites,20850,19417,1433,441,364
All,2018 Q3,F,Construction,Private sector sites,65489,56403,9086,56,887
All,2018 Q3,F,Construction,Private sector building sites,63600,54648,8952,54,802
All,2018 Q3,F,Construction,Private sector civil engineering sites,1889,1755,134,2,85
All,2018 Q3,G,"Import/export, wholesale and retail trades",Import and export trade,476020,248894,227126,6231,100181
All,2018 Q3,G,"Import/export, wholesale and retail trades",Wholesale,59902,33901,26001,1334,13489
All,2018 Q3,G,"Import/export, wholesale and retail trades",Retail trade,273115,104578,168537,8014,64160
All,2018 Q3,H,"Transportation, storage, postal and courier services",Land transport,44646,38261,6385,1339,1665
All,2018 Q3,H,"Transportation, storage, postal and courier services",Water transport,11388,7247,4141,155,402
All,2018 Q3,H,"Transportation, storage, postal and courier services",Air transport,28337,10981,17356,295,169
All,2018 Q3,H,"Transportation, storage, postal and courier services",Warehousing and support services for transportation,81085,51451,29634,2340,7077
All,2018 Q3,H,"Transportation, storage, postal and courier services",Postal and courier services,14560,10461,4099,350,824
All,2018 Q3,I,Accommodation and food services,Accommodation services,41514,21668,19846,2197,1262
All,2018 Q3,I,Accommodation and food services,Food and beverage services,251611,111636,139975,12061,17961
All,2018 Q3,J,Information and communications,Publishing,19081,10277,8804,366,1548
All,2018 Q3,J,Information and communications,"Motion picture, video and television programme production, sound recording and music publishing; Programming and broadcasting",16459,9936,6523,239,2865
All,2018 Q3,J,Information and communications,Telecommunications,19949,12502,7447,485,362
All,2018 Q3,J,Information and communications,Information technology services,46359,35076,11283,1462,8625
All,2018 Q3,J,Information and communications,Information services,7244,4017,3227,237,1167
All,2018 Q3,K,Financing and insurance,Financial services (except insurance and pension funding),140095,68374,71721,3462,8142
All,2018 Q3,K,Financing and insurance,Insurance,17437,7125,10312,731,175
All,2018 Q3,K,Financing and insurance,Services auxiliary to financial and insurance services,73660,36376,37284,1839,18220
All,2018 Q3,L,Real estate,Real estate,133922,79333,54589,4298,16812
All,2018 Q3,M,"Professional, scientific and technical services",Legal and accounting services,55125,24945,30180,1025,8449
All,2018 Q3,M,"Professional, scientific and technical services",Activities of head offices; management and management consultancy services,39856,17919,21937,1076,9025
All,2018 Q3,M,"Professional, scientific and technical services","Architecture and engineering services, technical testing and analysis",42383,28634,13749,781,3554
All,2018 Q3,M,"Professional, scientific and technical services",Scientific research and development,2988,2045,943,218,294
All,2018 Q3,M,"Professional, scientific and technical services",Advertising and market research,15099,8025,7074,349,3639
All,2018 Q3,M,"Professional, scientific and technical services","Veterinary services; Other professional, scientific and technical services",25906,14785,11121,632,9643
All,2018 Q3,N,Administrative and support services,Rental and leasing services,3563,2339,1224,143,753
All,2018 Q3,N,Administrative and support services,Employment services,19636,8694,10942,593,3045
All,2018 Q3,N,Administrative and support services,"Travel agency, reservation service and related services",19700,7548,12152,474,2897
All,2018 Q3,N,Administrative and support services,Security and investigation services,53768,35006,18762,2211,242
All,2018 Q3,N,Administrative and support services,Services to buildings and landscape care,84349,29194,55155,2252,1840
All,2018 Q3,N,Administrative and support services,"Office administrative, office support and other business support services",21562,10454,11108,458,5310
All,2018 Q3,P,Education,Education,202230,74477,127753,4831,16040
All,2018 Q3,Q,Human health and social work services,Human health services,129820,35107,94713,2914,8723
All,2018 Q3,Q,Human health and social work services,Residential care services,32623,5106,27517,2995,1152
All,2018 Q3,Q,Human health and social work services,Social work services,31271,7463,23808,902,2091
All,2018 Q3,R,"Arts, entertainment and recreation",Creative and performing arts activities,4686,2529,2157,51,1883
All,2018 Q3,R,"Arts, entertainment and recreation","Libraries, archives, museums and other cultural activities",725,244,481,18,90
All,2018 Q3,R,"Arts, entertainment and recreation",Amusement parks and theme parks,7854,3952,3902,636,11
All,2018 Q3,R,"Arts, entertainment and recreation",Sports and other entertainment services,36148,18363,17785,1977,1461
All,2018 Q3,S,Other services,Activities of membership organisations,11171,4582,6589,410,1378
All,2018 Q3,S,Other services,"Repair of motor vehicles, motorcycles, computers, personal and household goods",19197,15661,3536,644,6688
All,2018 Q3,S,Other services,Other personal services,47231,13399,33832,1672,12413
All,2018 Q4,C,Manufacturing,Manufacture of food products,27616,13794,13822,1470,1398
All,2018 Q4,C,Manufacturing,Manufacture of beverages,3280,2390,890,52,39
All,2018 Q4,C,Manufacturing,Manufacture of tobacco products,574,367,207,32,4
All,2018 Q4,C,Manufacturing,Manufacture of textiles,2106,904,1202,28,383
All,2018 Q4,C,Manufacturing,Manufacture of wearing apparel,3597,1605,1992,4,563
All,2018 Q4,C,Manufacturing,"Manufacture of leather and related products; Manufacture of wood and of products of wood and cork, articles of straw and plaiting materials (except furniture and toys)",350,251,99,1,114
All,2018 Q4,C,Manufacturing,Manufacture of paper and paper products,699,456,243,1,206
All,2018 Q4,C,Manufacturing,Printing and reproduction of recorded media,12661,8631,4030,130,2111
All,2018 Q4,C,Manufacturing,Manufacture of coke and refined petroleum products; Manufacture of chemicals and chemical products,1543,854,689,42,183
All,2018 Q4,C,Manufacturing,"Manufacture of pharmaceuticals, medicinal chemical and botanical products",5354,2128,3226,154,223
All,2018 Q4,C,Manufacturing,"Manufacture of rubber and plastics products (except furniture, toys, sports goods and stationery)",1927,1152,775,34,245
All,2018 Q4,C,Manufacturing,Manufacture of other non-metallic mineral products,1579,1292,287,28,190
All,2018 Q4,C,Manufacturing,Manufacture of basic metals,948,784,164,20,59
All,2018 Q4,C,Manufacturing,Manufacture of fabricated metal products (except machinery and equipment),2277,1833,444,5,570
All,2018 Q4,C,Manufacturing,"Manufacture of computer, electronic and optical products",2293,1268,1025,26,187
All,2018 Q4,C,Manufacturing,Manufacture of electrical equipment,1252,855,397,15,146
All,2018 Q4,C,Manufacturing,Manufacture of machinery and equipment n.e.c.,1363,1127,236,5,226
All,2018 Q4,C,Manufacturing,Body assembly of motor vehicles; Manufacture of other transport equipment,361,284,77,16,72
All,2018 Q4,C,Manufacturing,Manufacture of furniture,342,242,100,20,125
All,2018 Q4,C,Manufacturing,Other manufacturing,5565,3396,2169,79,1103
All,2018 Q4,C,Manufacturing,Repair and installation of machinery and equipment,14410,11951,2459,778,1200
All,2018 Q4,B,Mining and quarrying,Quarrying and other mining of non-metal ores,31,31,0,0,1
All,2018 Q4,D,Electricity and gas supply,Electricity and gas supply,7919,6375,1544,100,10
All,2018 Q4,E,"Sewerage, waste management and remediation services",Sewerage,162,121,41,3,26
All,2018 Q4,E,"Sewerage, waste management and remediation services","Waste collection, treatment and disposal; materials recovery",3236,2247,989,89,364
All,2018 Q4,E,"Sewerage, waste management and remediation services",Remediation and other waste management services,7,5,2,0,4
All,2018 Q4,F,Construction,Construction sites (manual workers only),103017,90649,12368,853,1489
All,2018 Q4,F,Construction,Public sector sites,37716,34913,2803,455,629
All,2018 Q4,F,Construction,Public sector building sites,20556,18803,1753,28,291
All,2018 Q4,F,Construction,Public sector civil engineering sites,17160,16110,1050,427,338
All,2018 Q4,F,Construction,Private sector sites,65301,55736,9565,398,860
All,2018 Q4,F,Construction,Private sector building sites,63218,53781,9437,374,788
All,2018 Q4,F,Construction,Private sector civil engineering sites,2083,1955,128,24,72
All,2018 Q4,G,"Import/export, wholesale and retail trades",Import and export trade,474758,244615,230143,5830,99986
All,2018 Q4,G,"Import/export, wholesale and retail trades",Wholesale,59676,35563,24113,1196,13450
All,2018 Q4,G,"Import/export, wholesale and retail trades",Retail trade,274077,105236,168841,8766,64238
All,2018 Q4,H,"Transportation, storage, postal and courier services",Land transport,44466,37755,6711,1180,1643
All,2018 Q4,H,"Transportation, storage, postal and courier services",Water transport,11500,6982,4518,104,402
All,2018 Q4,H,"Transportation, storage, postal and courier services",Air transport,28606,10851,17755,278,170
All,2018 Q4,H,"Transportation, storage, postal and courier services",Warehousing and support services for transportation,80604,50381,30223,2287,7150
All,2018 Q4,H,"Transportation, storage, postal and courier services",Postal and courier services,14963,11020,3943,405,829
All,2018 Q4,I,Accommodation and food services,Accommodation services,42234,22151,20083,2113,1271
All,2018 Q4,I,Accommodation and food services,Food and beverage services,252044,110491,141553,11794,18138
All,2018 Q4,J,Information and communications,Publishing,19122,10398,8724,385,1551
All,2018 Q4,J,Information and communications,"Motion picture, video and television programme production, sound recording and music publishing; Programming and broadcasting",16659,9574,7085,257,2911
All,2018 Q4,J,Information and communications,Telecommunications,19896,12468,7428,478,368
All,2018 Q4,J,Information and communications,Information technology services,46966,35214,11752,1401,8692
All,2018 Q4,J,Information and communications,Information services,7292,4299,2993,259,1186
All,2018 Q4,K,Financing and insurance,Financial services (except insurance and pension funding),141123,69616,71507,3591,8254
All,2018 Q4,K,Financing and insurance,Insurance,17400,7282,10118,657,176
All,2018 Q4,K,Financing and insurance,Services auxiliary to financial and insurance services,74957,38182,36775,1829,18418
All,2018 Q4,L,Real estate,Real estate,134972,79672,55300,3988,16911
All,2018 Q4,M,"Professional, scientific and technical services",Legal and accounting services,55811,25262,30549,1177,8538
All,2018 Q4,M,"Professional, scientific and technical services",Activities of head offices; management and management consultancy services,40423,19317,21106,984,9093
All,2018 Q4,M,"Professional, scientific and technical services","Architecture and engineering services, technical testing and analysis",42807,29331,13476,637,3600
All,2018 Q4,M,"Professional, scientific and technical services",Scientific research and development,3106,2083,1023,169,310
All,2018 Q4,M,"Professional, scientific and technical services",Advertising and market research,15213,8473,6740,290,3663
All,2018 Q4,M,"Professional, scientific and technical services","Veterinary services; Other professional, scientific and technical services",26561,15464,11097,626,9760
All,2018 Q4,N,Administrative and support services,Rental and leasing services,3618,2445,1173,88,762
All,2018 Q4,N,Administrative and support services,Employment services,20242,8563,11679,629,3075
All,2018 Q4,N,Administrative and support services,"Travel agency, reservation service and related services",19425,7460,11965,444,2884
All,2018 Q4,N,Administrative and support services,Security and investigation services,53156,35027,18129,2159,244
All,2018 Q4,N,Administrative and support services,Services to buildings and landscape care,83764,29824,53940,2255,1867
All,2018 Q4,N,Administrative and support services,"Office administrative, office support and other business support services",21746,10390,11356,455,5370
All,2018 Q4,P,Education,Education,204658,74893,129765,4565,16183
All,2018 Q4,Q,Human health and social work services,Human health services,132044,36054,95990,2959,8803
All,2018 Q4,Q,Human health and social work services,Residential care services,32838,5299,27539,3366,1152
All,2018 Q4,Q,Human health and social work services,Social work services,31065,8177,22888,988,2100
All,2018 Q4,R,"Arts, entertainment and recreation",Creative and performing arts activities,4760,2444,2316,128,1884
All,2018 Q4,R,"Arts, entertainment and recreation","Libraries, archives, museums and other cultural activities",745,249,496,19,94
All,2018 Q4,R,"Arts, entertainment and recreation",Amusement parks and theme parks,7492,3692,3800,279,11
All,2018 Q4,R,"Arts, entertainment and recreation",Sports and other entertainment services,36525,19433,17092,2194,1483
All,2018 Q4,S,Other services,Activities of membership organisations,11120,4911,6209,448,1381
All,2018 Q4,S,Other services,"Repair of motor vehicles, motorcycles, computers, personal and household goods",19106,15948,3158,492,6676
All,2018 Q4,S,Other services,Other personal services,47306,13382,33924,2050,12387
All,2019 Q1,C,Manufacturing,Manufacture of food products,27387,13796,13591,1174,1452
All,2019 Q1,C,Manufacturing,Manufacture of beverages,3250,2438,812,33,39
All,2019 Q1,C,Manufacturing,Manufacture of tobacco products,575,369,206,31,4
All,2019 Q1,C,Manufacturing,Manufacture of textiles,2088,954,1134,24,382
All,2019 Q1,C,Manufacturing,Manufacture of wearing apparel,3468,1323,2145,3,558
All,2019 Q1,C,Manufacturing,"Manufacture of leather and related products; Manufacture of wood and of products of wood and cork, articles of straw and plaiting materials (except furniture and toys)",300,211,89,2,115
All,2019 Q1,C,Manufacturing,Manufacture of paper and paper products,659,474,185,0,199
All,2019 Q1,C,Manufacturing,Printing and reproduction of recorded media,12253,8341,3912,114,2074
All,2019 Q1,C,Manufacturing,Manufacture of coke and refined petroleum products; Manufacture of chemicals and chemical products,1563,1088,475,30,184
All,2019 Q1,C,Manufacturing,"Manufacture of pharmaceuticals, medicinal chemical and botanical products",5285,2114,3171,136,222
All,2019 Q1,C,Manufacturing,"Manufacture of rubber and plastics products (except furniture, toys, sports goods and stationery)",1871,1302,569,62,241
All,2019 Q1,C,Manufacturing,Manufacture of other non-metallic mineral products,1578,1321,257,39,188
All,2019 Q1,C,Manufacturing,Manufacture of basic metals,877,708,169,20,56
All,2019 Q1,C,Manufacturing,Manufacture of fabricated metal products (except machinery and equipment),2246,1622,624,33,559
All,2019 Q1,C,Manufacturing,"Manufacture of computer, electronic and optical products",2200,1211,989,30,188
All,2019 Q1,C,Manufacturing,Manufacture of electrical equipment,1216,868,348,26,140
All,2019 Q1,C,Manufacturing,Manufacture of machinery and equipment n.e.c.,1336,1110,226,20,218
All,2019 Q1,C,Manufacturing,Body assembly of motor vehicles; Manufacture of other transport equipment,365,293,72,3,73
All,2019 Q1,C,Manufacturing,Manufacture of furniture,332,254,78,5,122
All,2019 Q1,C,Manufacturing,Other manufacturing,5428,3313,2115,107,1088
All,2019 Q1,C,Manufacturing,Repair and installation of machinery and equipment,14245,11857,2388,596,1179
All,2019 Q1,B,Mining and quarrying,Quarrying and other mining of non-metal ores,29,29,0,0,1
All,2019 Q1,D,Electricity and gas supply,Electricity and gas supply,7869,6345,1524,126,10
All,2019 Q1,E,"Sewerage, waste management and remediation services",Sewerage,153,112,41,0,26
All,2019 Q1,E,"Sewerage, waste management and remediation services","Waste collection, treatment and disposal; materials recovery",3240,2346,894,94,372
All,2019 Q1,E,"Sewerage, waste management and remediation services",Remediation and other waste management services,8,5,3,0,3
All,2019 Q1,F,Construction,Construction sites (manual workers only),107448,94475,12973,868,1565
All,2019 Q1,F,Construction,Public sector sites,37530,34669,2861,474,653
All,2019 Q1,F,Construction,Public sector building sites,19167,17439,1728,27,299
All,2019 Q1,F,Construction,Public sector civil engineering sites,18363,17230,1133,447,354
All,2019 Q1,F,Construction,Private sector sites,69918,59806,10112,394,912
All,2019 Q1,F,Construction,Private sector building sites,67430,57556,9874,382,817
All,2019 Q1,F,Construction,Private sector civil engineering sites,2488,2250,238,12,95
All,2019 Q1,G,"Import/export, wholesale and retail trades",Import and export trade,460128,241290,218838,5571,98989
All,2019 Q1,G,"Import/export, wholesale and retail trades",Wholesale,59147,35151,23996,1228,13448
All,2019 Q1,G,"Import/export, wholesale and retail trades",Retail trade,272598,108694,163904,8349,64574
All,2019 Q1,H,"Transportation, storage, postal and courier services",Land transport,44917,38230,6687,1434,1642
All,2019 Q1,H,"Transportation, storage, postal and courier services",Water transport,11597,7220,4377,161,407
All,2019 Q1,H,"Transportation, storage, postal and courier services",Air transport,28823,11011,17812,302,169
All,2019 Q1,H,"Transportation, storage, postal and courier services",Warehousing and support services for transportation,80014,50393,29621,2303,7177
All,2019 Q1,H,"Transportation, storage, postal and courier services",Postal and courier services,15317,11485,3832,578,835
All,2019 Q1,I,Accommodation and food services,Accommodation services,42202,21991,20211,2423,1274
All,2019 Q1,I,Accommodation and food services,Food and beverage services,251764,110919,140845,12280,18286
All,2019 Q1,J,Information and communications,Publishing,19199,9903,9296,353,1551
All,2019 Q1,J,Information and communications,"Motion picture, video and television programme production, sound recording and music publishing; Programming and broadcasting",16750,9653,7097,303,2963
All,2019 Q1,J,Information and communications,Telecommunications,20037,12134,7903,489,376
All,2019 Q1,J,Information and communications,Information technology services,47211,34856,12355,1567,8780
All,2019 Q1,J,Information and communications,Information services,7381,4416,2965,236,1198
All,2019 Q1,K,Financing and insurance,Financial services (except insurance and pension funding),136214,65909,70305,4095,8333
All,2019 Q1,K,Financing and insurance,Insurance,17180,7320,9860,499,177
All,2019 Q1,K,Financing and insurance,Services auxiliary to financial and insurance services,82722,40958,41764,1872,18606
All,2019 Q1,L,Real estate,Real estate,135486,78878,56608,4006,17153
All,2019 Q1,M,"Professional, scientific and technical services",Legal and accounting services,56447,25254,31193,1180,8584
All,2019 Q1,M,"Professional, scientific and technical services",Activities of head offices; management and management consultancy services,40445,18252,22193,1099,9266
All,2019 Q1,M,"Professional, scientific and technical services","Architecture and engineering services, technical testing and analysis",42903,28835,14068,875,3636
All,2019 Q1,M,"Professional, scientific and technical services",Scientific research and development,3229,2193,1036,229,345
All,2019 Q1,M,"Professional, scientific and technical services",Advertising and market research,15226,7328,7898,289,3701
All,2019 Q1,M,"Professional, scientific and technical services","Veterinary services; Other professional, scientific and technical services",26959,15061,11898,654,9853
All,2019 Q1,N,Administrative and support services,Rental and leasing services,3664,2492,1172,67,763
All,2019 Q1,N,Administrative and support services,Employment services,20351,8348,12003,533,3084
All,2019 Q1,N,Administrative and support services,"Travel agency, reservation service and related services",19335,7490,11845,316,2890
All,2019 Q1,N,Administrative and support services,Security and investigation services,53134,34295,18839,2363,249
All,2019 Q1,N,Administrative and support services,Services to buildings and landscape care,83750,29337,54413,2129,1876
All,2019 Q1,N,Administrative and support services,"Office administrative, office support and other business support services",21997,10235,11762,362,5380
All,2019 Q1,P,Education,Education,206227,74597,131630,4797,16230
All,2019 Q1,Q,Human health and social work services,Human health services,133974,36486,97488,3407,8847
All,2019 Q1,Q,Human health and social work services,Residential care services,32933,5373,27560,3292,1149
All,2019 Q1,Q,Human health and social work services,Social work services,31242,7506,23736,978,2099
All,2019 Q1,R,"Arts, entertainment and recreation",Creative and performing arts activities,4742,2500,2242,48,1886
All,2019 Q1,R,"Arts, entertainment and recreation","Libraries, archives, museums and other cultural activities",762,297,465,14,95
All,2019 Q1,R,"Arts, entertainment and recreation",Amusement parks and theme parks,7142,3532,3610,307,11
All,2019 Q1,R,"Arts, entertainment and recreation",Sports and other entertainment services,37141,18849,18292,2163,1460
All,2019 Q1,S,Other services,Activities of membership organisations,11153,4961,6192,489,1384
All,2019 Q1,S,Other services,"Repair of motor vehicles, motorcycles, computers, personal and household goods",18914,15679,3235,403,6645
All,2019 Q1,S,Other services,Other personal services,46646,13490,33156,1960,12336
All,2019 Q2,C,Manufacturing,Manufacture of food products,26929,13150,13779,1182,1477
All,2019 Q2,C,Manufacturing,Manufacture of beverages,3243,2402,841,25,39
All,2019 Q2,C,Manufacturing,Manufacture of tobacco products,578,360,218,45,4
All,2019 Q2,C,Manufacturing,Manufacture of textiles,2008,1058,950,5,372
All,2019 Q2,C,Manufacturing,Manufacture of wearing apparel,3315,1293,2022,19,544
All,2019 Q2,C,Manufacturing,"Manufacture of leather and related products; Manufacture of wood and of products of wood and cork, articles of straw and plaiting materials (except furniture and toys)",310,199,111,2,114
All,2019 Q2,C,Manufacturing,Manufacture of paper and paper products,649,405,244,4,195
All,2019 Q2,C,Manufacturing,Printing and reproduction of recorded media,12065,8003,4062,115,2048
All,2019 Q2,C,Manufacturing,Manufacture of coke and refined petroleum products; Manufacture of chemicals and chemical products,1516,1002,514,17,179
All,2019 Q2,C,Manufacturing,"Manufacture of pharmaceuticals, medicinal chemical and botanical products",5484,2243,3241,176,220
All,2019 Q2,C,Manufacturing,"Manufacture of rubber and plastics products (except furniture, toys, sports goods and stationery)",1837,1217,620,87,235
All,2019 Q2,C,Manufacturing,Manufacture of other non-metallic mineral products,1573,1267,306,37,186
All,2019 Q2,C,Manufacturing,Manufacture of basic metals,894,737,157,21,56
All,2019 Q2,C,Manufacturing,Manufacture of fabricated metal products (except machinery and equipment),2170,1699,471,59,550
All,2019 Q2,C,Manufacturing,"Manufacture of computer, electronic and optical products",2119,1131,988,35,179
All,2019 Q2,C,Manufacturing,Manufacture of electrical equipment,1203,825,378,30,138
All,2019 Q2,C,Manufacturing,Manufacture of machinery and equipment n.e.c.,1288,1020,268,25,218
All,2019 Q2,C,Manufacturing,Body assembly of motor vehicles; Manufacture of other transport equipment,351,296,55,8,71
All,2019 Q2,C,Manufacturing,Manufacture of furniture,333,214,119,6,121
All,2019 Q2,C,Manufacturing,Other manufacturing,5328,3453,1875,143,1074
All,2019 Q2,C,Manufacturing,Repair and installation of machinery and equipment,14193,11885,2308,621,1167
All,2019 Q2,B,Mining and quarrying,Quarrying and other mining of non-metal ores,26,26,0,0,1
All,2019 Q2,D,Electricity and gas supply,Electricity and gas supply,8302,6626,1676,118,10
All,2019 Q2,E,"Sewerage, waste management and remediation services",Sewerage,162,119,43,0,26
All,2019 Q2,E,"Sewerage, waste management and remediation services","Waste collection, treatment and disposal; materials recovery",3220,2350,870,114,379
All,2019 Q2,E,"Sewerage, waste management and remediation services",Remediation and other waste management services,7,4,3,0,2
All,2019 Q2,F,Construction,Construction sites (manual workers only),102723,90623,12100,775,1585
All,2019 Q2,F,Construction,Public sector sites,35937,33173,2764,445,669
All,2019 Q2,F,Construction,Public sector building sites,18222,16617,1605,12,315
All,2019 Q2,F,Construction,Public sector civil engineering sites,17715,16556,1159,433,354
All,2019 Q2,F,Construction,Private sector sites,66786,57450,9336,330,916
All,2019 Q2,F,Construction,Private sector building sites,64174,55083,9091,320,824
All,2019 Q2,F,Construction,Private sector civil engineering sites,2612,2367,245,10,92
All,2019 Q2,G,"Import/export, wholesale and retail trades",Import and export trade,453479,231931,221548,5443,98592
All,2019 Q2,G,"Import/export, wholesale and retail trades",Wholesale,58261,35190,23071,1024,13358
All,2019 Q2,G,"Import/export, wholesale and retail trades",Retail trade,271222,105572,165650,7653,64352
All,2019 Q2,H,"Transportation, storage, postal and courier services",Land transport,45049,37873,7176,1260,1614
All,2019 Q2,H,"Transportation, storage, postal and courier services",Water transport,11576,7111,4465,157,409
All,2019 Q2,H,"Transportation, storage, postal and courier services",Air transport,28393,10533,17860,262,164
All,2019 Q2,H,"Transportation, storage, postal and courier services",Warehousing and support services for transportation,79488,50271,29217,2143,7196
All,2019 Q2,H,"Transportation, storage, postal and courier services",Postal and courier services,15787,12241,3546,267,822
All,2019 Q2,I,Accommodation and food services,Accommodation services,41958,21764,20194,2045,1271
All,2019 Q2,I,Accommodation and food services,Food and beverage services,251558,110986,140572,9143,18480
All,2019 Q2,J,Information and communications,Publishing,19113,9719,9394,346,1546
All,2019 Q2,J,Information and communications,"Motion picture, video and television programme production, sound recording and music publishing; Programming and broadcasting",16712,9620,7092,351,2981
All,2019 Q2,J,Information and communications,Telecommunications,20193,12672,7521,545,382
All,2019 Q2,J,Information and communications,Information technology services,47453,35615,11838,1570,8851
All,2019 Q2,J,Information and communications,Information services,7478,4408,3070,232,1206
All,2019 Q2,K,Financing and insurance,Financial services (except insurance and pension funding),136383,66234,70149,3866,8402
All,2019 Q2,K,Financing and insurance,Insurance,17096,7293,9803,704,175
All,2019 Q2,K,Financing and insurance,Services auxiliary to financial and insurance services,83539,41848,41691,1883,18759
All,2019 Q2,L,Real estate,Real estate,135283,76689,58594,3773,17261
All,2019 Q2,M,"Professional, scientific and technical services",Legal and accounting services,56653,25269,31384,1138,8635
All,2019 Q2,M,"Professional, scientific and technical services",Activities of head offices; management and management consultancy services,40823,18665,22158,868,9421
All,2019 Q2,M,"Professional, scientific and technical services","Architecture and engineering services, technical testing and analysis",42924,28640,14284,792,3644
All,2019 Q2,M,"Professional, scientific and technical services",Scientific research and development,3234,2197,1037,247,351
All,2019 Q2,M,"Professional, scientific and technical services",Advertising and market research,15008,7827,7181,278,3699
All,2019 Q2,M,"Professional, scientific and technical services","Veterinary services; Other professional, scientific and technical services",27300,15020,12280,662,9921
All,2019 Q2,N,Administrative and support services,Rental and leasing services,3644,2519,1125,139,763
All,2019 Q2,N,Administrative and support services,Employment services,20640,8431,12209,540,3100
All,2019 Q2,N,Administrative and support services,"Travel agency, reservation service and related services",19264,7398,11866,393,2888
All,2019 Q2,N,Administrative and support services,Security and investigation services,53077,34583,18494,2422,253
All,2019 Q2,N,Administrative and support services,Services to buildings and landscape care,83852,30067,53785,1973,1886
All,2019 Q2,N,Administrative and support services,"Office administrative, office support and other business support services",22028,10441,11587,452,5405
All,2019 Q2,P,Education,Education,206191,75214,130977,5060,16388
All,2019 Q2,Q,Human health and social work services,Human health services,134342,36618,97724,3179,8921
All,2019 Q2,Q,Human health and social work services,Residential care services,33674,5290,28384,3403,1172
All,2019 Q2,Q,Human health and social work services,Social work services,31651,8505,23146,1065,2100
All,2019 Q2,R,"Arts, entertainment and recreation",Creative and performing arts activities,4722,2514,2208,68,1874
All,2019 Q2,R,"Arts, entertainment and recreation","Libraries, archives, museums and other cultural activities",775,266,509,8,93
All,2019 Q2,R,"Arts, entertainment and recreation",Amusement parks and theme parks,8240,4062,4178,208,11
All,2019 Q2,R,"Arts, entertainment and recreation",Sports and other entertainment services,37139,18463,18676,1551,1493
All,2019 Q2,S,Other services,Activities of membership organisations,11207,4851,6356,437,1390
All,2019 Q2,S,Other services,"Repair of motor vehicles, motorcycles, computers, personal and household goods",18855,15364,3491,483,6657
All,2019 Q2,S,Other services,Other personal services,46618,13585,33033,1754,12395
All,2019 Q3,C,Manufacturing,Manufacture of food products,26727,13439,13288,946,1482
All,2019 Q3,C,Manufacturing,Manufacture of beverages,3247,2428,819,31,39
All,2019 Q3,C,Manufacturing,Manufacture of tobacco products,583,363,220,25,4
All,2019 Q3,C,Manufacturing,Manufacture of textiles,1969,727,1242,7,362
All,2019 Q3,C,Manufacturing,Manufacture of wearing apparel,3149,1413,1736,4,528
All,2019 Q3,C,Manufacturing,"Manufacture of leather and related products; Manufacture of wood and of products of wood and cork, articles of straw and plaiting materials (except furniture and toys)",312,205,107,5,111
All,2019 Q3,C,Manufacturing,Manufacture of paper and paper products,629,449,180,0,192
All,2019 Q3,C,Manufacturing,Printing and reproduction of recorded media,11784,7518,4266,63,2006
All,2019 Q3,C,Manufacturing,Manufacture of coke and refined petroleum products; Manufacture of chemicals and chemical products,1518,1142,376,13,180
All,2019 Q3,C,Manufacturing,"Manufacture of pharmaceuticals, medicinal chemical and botanical products",5590,2247,3343,145,220
All,2019 Q3,C,Manufacturing,"Manufacture of rubber and plastics products (except furniture, toys, sports goods and stationery)",1817,1081,736,54,238
All,2019 Q3,C,Manufacturing,Manufacture of other non-metallic mineral products,1517,1290,227,43,185
All,2019 Q3,C,Manufacturing,Manufacture of basic metals,894,701,193,10,56
All,2019 Q3,C,Manufacturing,Manufacture of fabricated metal products (except machinery and equipment),2150,1502,648,2,541
All,2019 Q3,C,Manufacturing,"Manufacture of computer, electronic and optical products",2018,1116,902,20,165
All,2019 Q3,C,Manufacturing,Manufacture of electrical equipment,1154,816,338,23,137
All,2019 Q3,C,Manufacturing,Manufacture of machinery and equipment n.e.c.,1248,973,275,6,213
All,2019 Q3,C,Manufacturing,Body assembly of motor vehicles; Manufacture of other transport equipment,333,292,41,12,68
All,2019 Q3,C,Manufacturing,Manufacture of furniture,326,249,77,4,118
All,2019 Q3,C,Manufacturing,Other manufacturing,5249,3306,1943,81,1062
All,2019 Q3,C,Manufacturing,Repair and installation of machinery and equipment,14129,11855,2274,419,1169
All,2019 Q3,B,Mining and quarrying,Quarrying and other mining of non-metal ores,17,17,0,0,1
All,2019 Q3,D,Electricity and gas supply,Electricity and gas supply,8147,6560,1587,108,10
All,2019 Q3,E,"Sewerage, waste management and remediation services",Sewerage,159,109,50,0,25
All,2019 Q3,E,"Sewerage, waste management and remediation services","Waste collection, treatment and disposal; materials recovery",3196,2314,882,116,377
All,2019 Q3,E,"Sewerage, waste management and remediation services",Remediation and other waste management services,5,4,1,0,2
All,2019 Q3,F,Construction,Construction sites (manual workers only),96891,85224,11667,577,1596
All,2019 Q3,F,Construction,Public sector sites,34331,31915,2416,451,651
All,2019 Q3,F,Construction,Public sector building sites,18215,16763,1452,23,305
All,2019 Q3,F,Construction,Public sector civil engineering sites,16116,15152,964,428,346
All,2019 Q3,F,Construction,Private sector sites,62560,53309,9251,126,945
All,2019 Q3,F,Construction,Private sector building sites,60083,51023,9060,123,853
All,2019 Q3,F,Construction,Private sector civil engineering sites,2477,2286,191,3,92
All,2019 Q3,G,"Import/export, wholesale and retail trades",Import and export trade,444646,231272,213374,5244,97509
All,2019 Q3,G,"Import/export, wholesale and retail trades",Wholesale,56781,33622,23159,922,13233
All,2019 Q3,G,"Import/export, wholesale and retail trades",Retail trade,266991,103648,163343,5969,63184
All,2019 Q3,H,"Transportation, storage, postal and courier services",Land transport,45078,37987,7091,1159,1590
All,2019 Q3,H,"Transportation, storage, postal and courier services",Water transport,11487,7019,4468,94,406
All,2019 Q3,H,"Transportation, storage, postal and courier services",Air transport,28641,10755,17886,251,166
All,2019 Q3,H,"Transportation, storage, postal and courier services",Warehousing and support services for transportation,79288,50357,28931,1993,7133
All,2019 Q3,H,"Transportation, storage, postal and courier services",Postal and courier services,15908,12316,3592,302,817
All,2019 Q3,I,Accommodation and food services,Accommodation services,41530,21771,19759,1089,1274
All,2019 Q3,I,Accommodation and food services,Food and beverage services,239247,108849,130398,5155,18018
All,2019 Q3,J,Information and communications,Publishing,18796,9487,9309,270,1511
All,2019 Q3,J,Information and communications,"Motion picture, video and television programme production, sound recording and music publishing; Programming and broadcasting",16612,9586,7026,325,2987
All,2019 Q3,J,Information and communications,Telecommunications,19859,12390,7469,480,377
All,2019 Q3,J,Information and communications,Information technology services,47601,35862,11739,1558,8818
All,2019 Q3,J,Information and communications,Information services,7557,4701,2856,229,1207
All,2019 Q3,K,Financing and insurance,Financial services (except insurance and pension funding),137142,66911,70231,3729,8407
All,2019 Q3,K,Financing and insurance,Insurance,17144,7299,9845,722,171
All,2019 Q3,K,Financing and insurance,Services auxiliary to financial and insurance services,83119,41982,41137,1693,18753
All,2019 Q3,L,Real estate,Real estate,135190,76316,58874,3555,17234
All,2019 Q3,M,"Professional, scientific and technical services",Legal and accounting services,56908,25855,31053,895,8662
All,2019 Q3,M,"Professional, scientific and technical services",Activities of head offices; management and management consultancy services,41163,19002,22161,786,9500
All,2019 Q3,M,"Professional, scientific and technical services","Architecture and engineering services, technical testing and analysis",42685,28486,14199,677,3635
All,2019 Q3,M,"Professional, scientific and technical services",Scientific research and development,3201,2187,1014,201,357
All,2019 Q3,M,"Professional, scientific and technical services",Advertising and market research,14811,8092,6719,219,3679
All,2019 Q3,M,"Professional, scientific and technical services","Veterinary services; Other professional, scientific and technical services",27091,15628,11463,556,9887
All,2019 Q3,N,Administrative and support services,Rental and leasing services,3596,2335,1261,80,748
All,2019 Q3,N,Administrative and support services,Employment services,20423,9196,11227,482,3056
All,2019 Q3,N,Administrative and support services,"Travel agency, reservation service and related services",19030,7611,11419,326,2850
All,2019 Q3,N,Administrative and support services,Security and investigation services,53378,34954,18424,2270,256
All,2019 Q3,N,Administrative and support services,Services to buildings and landscape care,84222,30770,53452,1978,1881
All,2019 Q3,N,Administrative and support services,"Office administrative, office support and other business support services",21854,9614,12240,391,5382
All,2019 Q3,P,Education,Education,206062,75759,130303,5139,16445
All,2019 Q3,Q,Human health and social work services,Human health services,136113,37220,98893,2962,8976
All,2019 Q3,Q,Human health and social work services,Residential care services,33834,5777,28057,3148,1174
All,2019 Q3,Q,Human health and social work services,Social work services,31812,7977,23835,1122,2104
All,2019 Q3,R,"Arts, entertainment and recreation",Creative and performing arts activities,4675,2296,2379,61,1874
All,2019 Q3,R,"Arts, entertainment and recreation","Libraries, archives, museums and other cultural activities",810,344,466,11,96
All,2019 Q3,R,"Arts, entertainment and recreation",Amusement parks and theme parks,9256,4590,4666,397,10
All,2019 Q3,R,"Arts, entertainment and recreation",Sports and other entertainment services,37385,19194,18191,1794,1489
All,2019 Q3,S,Other services,Activities of membership organisations,11196,4848,6348,424,1395
All,2019 Q3,S,Other services,"Repair of motor vehicles, motorcycles, computers, personal and household goods",18784,15564,3220,465,6583
All,2019 Q3,S,Other services,Other personal services,46632,13493,33139,1192,12380
All,2019 Q4,C,Manufacturing,Manufacture of food products,26263,13757,12506,844,1464
All,2019 Q4,C,Manufacturing,Manufacture of beverages,3235,2373,862,48,39
All,2019 Q4,C,Manufacturing,Manufacture of tobacco products,595,366,229,21,4
All,2019 Q4,C,Manufacturing,Manufacture of textiles,1859,893,966,9,352
All,2019 Q4,C,Manufacturing,Manufacture of wearing apparel,3118,1354,1764,11,524
All,2019 Q4,C,Manufacturing,"Manufacture of leather and related products; Manufacture of wood and of products of wood and cork, articles of straw and plaiting materials (except furniture and toys)",309,191,118,11,110
All,2019 Q4,C,Manufacturing,Manufacture of paper and paper products,614,366,248,0,188
All,2019 Q4,C,Manufacturing,Printing and reproduction of recorded media,11709,7516,4193,63,1993
All,2019 Q4,C,Manufacturing,Manufacture of coke and refined petroleum products; Manufacture of chemicals and chemical products,1531,1084,447,5,180
All,2019 Q4,C,Manufacturing,"Manufacture of pharmaceuticals, medicinal chemical and botanical products",5457,2202,3255,99,218
All,2019 Q4,C,Manufacturing,"Manufacture of rubber and plastics products (except furniture, toys, sports goods and stationery)",1791,1080,711,32,232
All,2019 Q4,C,Manufacturing,Manufacture of other non-metallic mineral products,1481,1083,398,39,183
All,2019 Q4,C,Manufacturing,Manufacture of basic metals,888,724,164,8,56
All,2019 Q4,C,Manufacturing,Manufacture of fabricated metal products (except machinery and equipment),2147,1570,577,8,538
All,2019 Q4,C,Manufacturing,"Manufacture of computer, electronic and optical products",1988,1081,907,22,162
All,2019 Q4,C,Manufacturing,Manufacture of electrical equipment,1144,777,367,7,137
All,2019 Q4,C,Manufacturing,Manufacture of machinery and equipment n.e.c.,1218,1025,193,9,207
All,2019 Q4,C,Manufacturing,Body assembly of motor vehicles; Manufacture of other transport equipment,323,283,40,0,67
All,2019 Q4,C,Manufacturing,Manufacture of furniture,327,247,80,0,118
All,2019 Q4,C,Manufacturing,Other manufacturing,5199,3234,1965,20,1054
All,2019 Q4,C,Manufacturing,Repair and installation of machinery and equipment,14191,11777,2414,537,1162
All,2019 Q4,B,Mining and quarrying,Quarrying and other mining of non-metal ores,17,17,0,0,1
All,2019 Q4,D,Electricity and gas supply,Electricity and gas supply,7917,6348,1569,116,9
All,2019 Q4,E,"Sewerage, waste management and remediation services",Sewerage,155,118,37,0,24
All,2019 Q4,E,"Sewerage, waste management and remediation services","Waste collection, treatment and disposal; materials recovery",3235,2362,873,119,380
All,2019 Q4,E,"Sewerage, waste management and remediation services",Remediation and other waste management services,8,6,2,0,3
All,2019 Q4,F,Construction,Construction sites (manual workers only),99938,88663,11275,498,1678
All,2019 Q4,F,Construction,Public sector sites,37662,34857,2805,444,703
All,2019 Q4,F,Construction,Public sector building sites,21424,19556,1868,14,363
All,2019 Q4,F,Construction,Public sector civil engineering sites,16238,15301,937,430,340
All,2019 Q4,F,Construction,Private sector sites,62276,53806,8470,54,975
All,2019 Q4,F,Construction,Private sector building sites,59923,51585,8338,46,878
All,2019 Q4,F,Construction,Private sector civil engineering sites,2353,2221,132,8,97
All,2019 Q4,G,"Import/export, wholesale and retail trades",Import and export trade,439050,227936,211114,4031,96880
All,2019 Q4,G,"Import/export, wholesale and retail trades",Wholesale,56348,32835,23513,726,13181
All,2019 Q4,G,"Import/export, wholesale and retail trades",Retail trade,261058,102593,158465,4865,62411
All,2019 Q4,H,"Transportation, storage, postal and courier services",Land transport,45132,37995,7137,891,1577
All,2019 Q4,H,"Transportation, storage, postal and courier services",Water transport,11384,7031,4353,48,407
All,2019 Q4,H,"Transportation, storage, postal and courier services",Air transport,28763,10687,18076,187,167
All,2019 Q4,H,"Transportation, storage, postal and courier services",Warehousing and support services for transportation,78963,49399,29564,1618,7163
All,2019 Q4,H,"Transportation, storage, postal and courier services",Postal and courier services,15985,11918,4067,73,807
All,2019 Q4,I,Accommodation and food services,Accommodation services,41343,21228,20115,924,1261
All,2019 Q4,I,Accommodation and food services,Food and beverage services,234496,104840,129656,3938,17683
All,2019 Q4,J,Information and communications,Publishing,18541,9635,8906,251,1490
All,2019 Q4,J,Information and communications,"Motion picture, video and television programme production, sound recording and music publishing; Programming and broadcasting",16408,9724,6684,174,2989
All,2019 Q4,J,Information and communications,Telecommunications,19820,12342,7478,445,380
All,2019 Q4,J,Information and communications,Information technology services,47859,35326,12533,1502,8847
All,2019 Q4,J,Information and communications,Information services,7654,4191,3463,185,1211
All,2019 Q4,K,Financing and insurance,Financial services (except insurance and pension funding),137691,67474,70217,3705,8437
All,2019 Q4,K,Financing and insurance,Insurance,17185,7320,9865,687,172
All,2019 Q4,K,Financing and insurance,Services auxiliary to financial and insurance services,83637,42087,41550,1633,18788
All,2019 Q4,L,Real estate,Real estate,135038,75742,59296,3278,17271
All,2019 Q4,M,"Professional, scientific and technical services",Legal and accounting services,56853,25559,31294,789,8692
All,2019 Q4,M,"Professional, scientific and technical services",Activities of head offices; management and management consultancy services,41282,20263,21019,678,9539
All,2019 Q4,M,"Professional, scientific and technical services","Architecture and engineering services, technical testing and analysis",42372,28560,13812,570,3639
All,2019 Q4,M,"Professional, scientific and technical services",Scientific research and development,3257,2382,875,182,368
All,2019 Q4,M,"Professional, scientific and technical services",Advertising and market research,14529,7767,6762,164,3663
All,2019 Q4,M,"Professional, scientific and technical services","Veterinary services; Other professional, scientific and technical services",26861,14905,11956,472,9875
All,2019 Q4,N,Administrative and support services,Rental and leasing services,3637,2246,1391,51,744
All,2019 Q4,N,Administrative and support services,Employment services,20327,8853,11474,341,3063
All,2019 Q4,N,Administrative and support services,"Travel agency, reservation service and related services",18682,6900,11782,235,2816
All,2019 Q4,N,Administrative and support services,Security and investigation services,53833,35497,18336,2050,259
All,2019 Q4,N,Administrative and support services,Services to buildings and landscape care,83848,30948,52900,1762,1887
All,2019 Q4,N,Administrative and support services,"Office administrative, office support and other business support services",21760,10464,11296,397,5378
All,2019 Q4,P,Education,Education,207606,74482,133124,4167,16409
All,2019 Q4,Q,Human health and social work services,Human health services,138994,37590,101404,3223,9006
All,2019 Q4,Q,Human health and social work services,Residential care services,34516,5907,28609,3262,1175
All,2019 Q4,Q,Human health and social work services,Social work services,32021,8129,23892,1162,2104
All,2019 Q4,R,"Arts, entertainment and recreation",Creative and performing arts activities,4625,2506,2119,39,1853
All,2019 Q4,R,"Arts, entertainment and recreation","Libraries, archives, museums and other cultural activities",810,325,485,5,101
All,2019 Q4,R,"Arts, entertainment and recreation",Amusement parks and theme parks,7719,3856,3863,122,10
All,2019 Q4,R,"Arts, entertainment and recreation",Sports and other entertainment services,37661,19128,18533,1718,1487
All,2019 Q4,S,Other services,Activities of membership organisations,11223,4863,6360,373,1395
All,2019 Q4,S,Other services,"Repair of motor vehicles, motorcycles, computers, personal and household goods",18549,15049,3500,185,6520
All,2019 Q4,S,Other services,Other personal services,46025,12850,33175,799,12277
All,2020 Q1,C,Manufacturing,Manufacture of food products,25743,12417,13326,340,1444
All,2020 Q1,C,Manufacturing,Manufacture of beverages,3217,2421,796,38,39
All,2020 Q1,C,Manufacturing,Manufacture of tobacco products,596,373,223,10,4
All,2020 Q1,C,Manufacturing,Manufacture of textiles,1828,822,1006,0,349
All,2020 Q1,C,Manufacturing,Manufacture of wearing apparel,3171,1486,1685,7,521
All,2020 Q1,C,Manufacturing,"Manufacture of leather and related products; Manufacture of wood and of products of wood and cork, articles of straw and plaiting materials (except furniture and toys)",309,207,102,0,107
All,2020 Q1,C,Manufacturing,Manufacture of paper and paper products,612,456,156,0,188
All,2020 Q1,C,Manufacturing,Printing and reproduction of recorded media,11603,7899,3704,52,1987
All,2020 Q1,C,Manufacturing,Manufacture of coke and refined petroleum products; Manufacture of chemicals and chemical products,1532,1090,442,21,179
All,2020 Q1,C,Manufacturing,"Manufacture of pharmaceuticals, medicinal chemical and botanical products",5368,1976,3392,35,213
All,2020 Q1,C,Manufacturing,"Manufacture of rubber and plastics products (except furniture, toys, sports goods and stationery)",1735,1169,566,18,227
All,2020 Q1,C,Manufacturing,Manufacture of other non-metallic mineral products,1492,1188,304,25,183
All,2020 Q1,C,Manufacturing,Manufacture of basic metals,813,595,218,7,54
All,2020 Q1,C,Manufacturing,Manufacture of fabricated metal products (except machinery and equipment),2134,1534,600,24,531
All,2020 Q1,C,Manufacturing,"Manufacture of computer, electronic and optical products",1910,1005,905,16,158
All,2020 Q1,C,Manufacturing,Manufacture of electrical equipment,1139,757,382,1,130
All,2020 Q1,C,Manufacturing,Manufacture of machinery and equipment n.e.c.,1181,917,264,1,204
All,2020 Q1,C,Manufacturing,Body assembly of motor vehicles; Manufacture of other transport equipment,332,279,53,0,66
All,2020 Q1,C,Manufacturing,Manufacture of furniture,317,236,81,2,112
All,2020 Q1,C,Manufacturing,Other manufacturing,5083,3379,1704,44,1047
All,2020 Q1,C,Manufacturing,Repair and installation of machinery and equipment,14124,11873,2251,116,1158
All,2020 Q1,B,Mining and quarrying,Quarrying and other mining of non-metal ores,30,30,0,0,1
All,2020 Q1,D,Electricity and gas supply,Electricity and gas supply,7688,6204,1484,61,9
All,2020 Q1,E,"Sewerage, waste management and remediation services",Sewerage,153,106,47,0,24
All,2020 Q1,E,"Sewerage, waste management and remediation services","Waste collection, treatment and disposal; materials recovery",3153,2284,869,80,382
All,2020 Q1,E,"Sewerage, waste management and remediation services",Remediation and other waste management services,7,5,2,0,2
All,2020 Q1,F,Construction,Construction sites (manual workers only),101060,89829,11231,498,1624
All,2020 Q1,F,Construction,Public sector sites,39012,36245,2767,456,762
All,2020 Q1,F,Construction,Public sector building sites,21823,20054,1769,29,394
All,2020 Q1,F,Construction,Public sector civil engineering sites,17189,16191,998,427,368
All,2020 Q1,F,Construction,Private sector sites,62048,53584,8464,42,862
All,2020 Q1,F,Construction,Private sector building sites,59450,51159,8291,40,783
All,2020 Q1,F,Construction,Private sector civil engineering sites,2598,2425,173,2,79
All,2020 Q1,G,"Import/export, wholesale and retail trades",Import and export trade,420121,220728,199393,3582,95622
All,2020 Q1,G,"Import/export, wholesale and retail trades",Wholesale,55258,33744,21514,494,13020
All,2020 Q1,G,"Import/export, wholesale and retail trades",Retail trade,254921,98367,156554,3048,61903
All,2020 Q1,H,"Transportation, storage, postal and courier services",Land transport,44782,38013,6769,1039,1565
All,2020 Q1,H,"Transportation, storage, postal and courier services",Water transport,10943,6604,4339,22,406
All,2020 Q1,H,"Transportation, storage, postal and courier services",Air transport,27576,9952,17624,90,169
All,2020 Q1,H,"Transportation, storage, postal and courier services",Warehousing and support services for transportation,77370,48513,28857,700,7159
All,2020 Q1,H,"Transportation, storage, postal and courier services",Postal and courier services,16626,12769,3857,740,796
All,2020 Q1,I,Accommodation and food services,Accommodation services,37984,19766,18218,706,1209
All,2020 Q1,I,Accommodation and food services,Food and beverage services,221549,98561,122988,2205,17281
All,2020 Q1,J,Information and communications,Publishing,18425,9367,9058,207,1489
All,2020 Q1,J,Information and communications,"Motion picture, video and television programme production, sound recording and music publishing; Programming and broadcasting",16121,9216,6905,150,2998
All,2020 Q1,J,Information and communications,Telecommunications,19835,12468,7367,386,381
All,2020 Q1,J,Information and communications,Information technology services,47594,35902,11692,1286,8881
All,2020 Q1,J,Information and communications,Information services,7766,4525,3241,165,1218
All,2020 Q1,K,Financing and insurance,Financial services (except insurance and pension funding),137893,67128,70765,3011,8442
All,2020 Q1,K,Financing and insurance,Insurance,17002,7092,9910,650,175
All,2020 Q1,K,Financing and insurance,Services auxiliary to financial and insurance services,83283,41848,41435,1538,18802
All,2020 Q1,L,Real estate,Real estate,134469,76815,57654,3014,17261
All,2020 Q1,M,"Professional, scientific and technical services",Legal and accounting services,57394,26239,31155,667,8709
All,2020 Q1,M,"Professional, scientific and technical services",Activities of head offices; management and management consultancy services,41613,18853,22760,718,9595
All,2020 Q1,M,"Professional, scientific and technical services","Architecture and engineering services, technical testing and analysis",42352,28395,13957,604,3676
All,2020 Q1,M,"Professional, scientific and technical services",Scientific research and development,3361,2280,1081,133,379
All,2020 Q1,M,"Professional, scientific and technical services",Advertising and market research,14318,7258,7060,148,3687
All,2020 Q1,M,"Professional, scientific and technical services","Veterinary services; Other professional, scientific and technical services",26808,14607,12201,242,9893
All,2020 Q1,N,Administrative and support services,Rental and leasing services,3630,2255,1375,33,747
All,2020 Q1,N,Administrative and support services,Employment services,19943,8439,11504,227,3058
All,2020 Q1,N,Administrative and support services,"Travel agency, reservation service and related services",17993,6274,11719,170,2780
All,2020 Q1,N,Administrative and support services,Security and investigation services,53422,36287,17135,1677,264
All,2020 Q1,N,Administrative and support services,Services to buildings and landscape care,83707,29772,53935,1471,1882
All,2020 Q1,N,Administrative and support services,"Office administrative, office support and other business support services",21628,10257,11371,355,5382
All,2020 Q1,P,Education,Education,205202,75390,129812,3690,16155
All,2020 Q1,Q,Human health and social work services,Human health services,139720,37639,102081,2336,9021
All,2020 Q1,Q,Human health and social work services,Residential care services,34674,5760,28914,3102,1177
All,2020 Q1,Q,Human health and social work services,Social work services,31174,8832,22342,954,2104
All,2020 Q1,R,"Arts, entertainment and recreation",Creative and performing arts activities,4595,2259,2336,28,1848
All,2020 Q1,R,"Arts, entertainment and recreation","Libraries, archives, museums and other cultural activities",776,282,494,34,101
All,2020 Q1,R,"Arts, entertainment and recreation",Amusement parks and theme parks,6240,3024,3216,131,10
All,2020 Q1,R,"Arts, entertainment and recreation",Sports and other entertainment services,35882,18382,17500,370,1478
All,2020 Q1,S,Other services,Activities of membership organisations,11064,4499,6565,278,1394
All,2020 Q1,S,Other services,"Repair of motor vehicles, motorcycles, computers, personal and household goods",18134,14926,3208,110,6479
All,2020 Q1,S,Other services,Other personal services,44840,13040,31800,362,12183
All,2020 Q2,C,Manufacturing,Manufacture of food products,25695,12053,13642,300,1438
All,2020 Q2,C,Manufacturing,Manufacture of beverages,3168,2340,828,33,39
All,2020 Q2,C,Manufacturing,Manufacture of tobacco products,596,372,224,13,3
All,2020 Q2,C,Manufacturing,Manufacture of textiles,1799,861,938,4,344
All,2020 Q2,C,Manufacturing,Manufacture of wearing apparel,3079,1305,1774,11,520
All,2020 Q2,C,Manufacturing,"Manufacture of leather and related products; Manufacture of wood and of products of wood and cork, articles of straw and plaiting materials (except furniture and toys)",303,198,105,0,107
All,2020 Q2,C,Manufacturing,Manufacture of paper and paper products,585,426,159,6,187
All,2020 Q2,C,Manufacturing,Printing and reproduction of recorded media,11408,7638,3770,51,1976
All,2020 Q2,C,Manufacturing,Manufacture of coke and refined petroleum products; Manufacture of chemicals and chemical products,1526,990,536,13,178
All,2020 Q2,C,Manufacturing,"Manufacture of pharmaceuticals, medicinal chemical and botanical products",5362,2241,3121,59,213
All,2020 Q2,C,Manufacturing,"Manufacture of rubber and plastics products (except furniture, toys, sports goods and stationery)",1747,1209,538,17,223
All,2020 Q2,C,Manufacturing,Manufacture of other non-metallic mineral products,1480,1147,333,22,183
All,2020 Q2,C,Manufacturing,Manufacture of basic metals,825,667,158,3,51
All,2020 Q2,C,Manufacturing,Manufacture of fabricated metal products (except machinery and equipment),2124,1621,503,2,523
All,2020 Q2,C,Manufacturing,"Manufacture of computer, electronic and optical products",1888,1030,858,17,158
All,2020 Q2,C,Manufacturing,Manufacture of electrical equipment,1145,762,383,5,129
All,2020 Q2,C,Manufacturing,Manufacture of machinery and equipment n.e.c.,1200,981,219,3,205
All,2020 Q2,C,Manufacturing,Body assembly of motor vehicles; Manufacture of other transport equipment,309,249,60,4,64
All,2020 Q2,C,Manufacturing,Manufacture of furniture,301,226,75,0,111
All,2020 Q2,C,Manufacturing,Other manufacturing,5650,3344,2306,159,1065
All,2020 Q2,C,Manufacturing,Repair and installation of machinery and equipment,13997,11903,2094,31,1157
All,2020 Q2,B,Mining and quarrying,Quarrying and other mining of non-metal ores,35,28,7,0,1
All,2020 Q2,D,Electricity and gas supply,Electricity and gas supply,7774,6241,1533,61,9
All,2020 Q2,E,"Sewerage, waste management and remediation services",Sewerage,155,117,38,0,24
All,2020 Q2,E,"Sewerage, waste management and remediation services","Waste collection, treatment and disposal; materials recovery",3206,2227,979,69,384
All,2020 Q2,E,"Sewerage, waste management and remediation services",Remediation and other waste management services,6,5,1,0,2
All,2020 Q2,F,Construction,Construction sites (manual workers only),97642,88192,9450,244,1659
All,2020 Q2,F,Construction,Public sector sites,40135,37349,2786,236,806
All,2020 Q2,F,Construction,Public sector building sites,23155,21251,1904,12,408
All,2020 Q2,F,Construction,Public sector civil engineering sites,16980,16098,882,224,398
All,2020 Q2,F,Construction,Private sector sites,57507,50843,6664,8,853
All,2020 Q2,F,Construction,Private sector building sites,55329,48837,6492,8,756
All,2020 Q2,F,Construction,Private sector civil engineering sites,2178,2006,172,0,97
All,2020 Q2,G,"Import/export, wholesale and retail trades",Import and export trade,397761,208529,189232,3194,94381
All,2020 Q2,G,"Import/export, wholesale and retail trades",Wholesale,52430,31873,20557,473,12858
All,2020 Q2,G,"Import/export, wholesale and retail trades",Retail trade,249359,97676,151683,3155,61650
All,2020 Q2,H,"Transportation, storage, postal and courier services",Land transport,44738,37403,7335,1015,1552
All,2020 Q2,H,"Transportation, storage, postal and courier services",Water transport,10883,6530,4353,46,415
All,2020 Q2,H,"Transportation, storage, postal and courier services",Air transport,27052,9984,17068,124,169
All,2020 Q2,H,"Transportation, storage, postal and courier services",Warehousing and support services for transportation,77387,47525,29862,824,7167
All,2020 Q2,H,"Transportation, storage, postal and courier services",Postal and courier services,16074,11878,4196,274,805
All,2020 Q2,I,Accommodation and food services,Accommodation services,35897,18701,17196,710,1159
All,2020 Q2,I,Accommodation and food services,Food and beverage services,212817,92694,120123,2128,16893
All,2020 Q2,J,Information and communications,Publishing,18368,9321,9047,212,1491
All,2020 Q2,J,Information and communications,"Motion picture, video and television programme production, sound recording and music publishing; Programming and broadcasting",16068,9185,6883,130,3004
All,2020 Q2,J,Information and communications,Telecommunications,19924,12325,7599,370,386
All,2020 Q2,J,Information and communications,Information technology services,48358,36101,12257,1185,8955
All,2020 Q2,J,Information and communications,Information services,8047,5003,3044,145,1225
All,2020 Q2,K,Financing and insurance,Financial services (except insurance and pension funding),138204,67730,70474,2592,8446
All,2020 Q2,K,Financing and insurance,Insurance,17198,7497,9701,649,179
All,2020 Q2,K,Financing and insurance,Services auxiliary to financial and insurance services,83287,41824,41463,1381,18829
All,2020 Q2,L,Real estate,Real estate,135223,77686,57537,2552,17306
All,2020 Q2,M,"Professional, scientific and technical services",Legal and accounting services,57374,26400,30974,553,8755
All,2020 Q2,M,"Professional, scientific and technical services",Activities of head offices; management and management consultancy services,42073,19566,22507,696,9644
All,2020 Q2,M,"Professional, scientific and technical services","Architecture and engineering services, technical testing and analysis",42878,28929,13949,609,3701
All,2020 Q2,M,"Professional, scientific and technical services",Scientific research and development,3541,2316,1225,107,391
All,2020 Q2,M,"Professional, scientific and technical services",Advertising and market research,14272,7056,7216,67,3705
All,2020 Q2,M,"Professional, scientific and technical services","Veterinary services; Other professional, scientific and technical services",26823,14659,12164,302,9940
All,2020 Q2,N,Administrative and support services,Rental and leasing services,3583,2379,1204,71,743
All,2020 Q2,N,Administrative and support services,Employment services,20045,8706,11339,216,3056
All,2020 Q2,N,Administrative and support services,"Travel agency, reservation service and related services",17600,6790,10810,169,2739
All,2020 Q2,N,Administrative and support services,Security and investigation services,52975,34877,18098,910,266
All,2020 Q2,N,Administrative and support services,Services to buildings and landscape care,83264,30269,52995,1231,1876
All,2020 Q2,N,Administrative and support services,"Office administrative, office support and other business support services",21518,10163,11355,256,5391
All,2020 Q2,P,Education,Education,203879,73908,129971,4146,16227
All,2020 Q2,Q,Human health and social work services,Human health services,140475,38652,101823,2083,9051
All,2020 Q2,Q,Human health and social work services,Residential care services,34939,6121,28818,3099,1179
All,2020 Q2,Q,Human health and social work services,Social work services,30779,7999,22780,924,2099
All,2020 Q2,R,"Arts, entertainment and recreation",Creative and performing arts activities,4562,2415,2147,29,1841
All,2020 Q2,R,"Arts, entertainment and recreation","Libraries, archives, museums and other cultural activities",767,283,484,22,101
All,2020 Q2,R,"Arts, entertainment and recreation",Amusement parks and theme parks,6260,3034,3226,143,10
All,2020 Q2,R,"Arts, entertainment and recreation",Sports and other entertainment services,35670,18600,17070,291,1487
All,2020 Q2,S,Other services,Activities of membership organisations,11075,4835,6240,301,1399
All,2020 Q2,S,Other services,"Repair of motor vehicles, motorcycles, computers, personal and household goods",18036,14806,3230,194,6488
All,2020 Q2,S,Other services,Other personal services,44517,13010,31507,416,12189